Season,Date,Home_Team,Away_Team,Home_Score,Away_Score,Home_Goal_Diff,Away_Goal_Diff,Result,Home_Last_5_Wins,Away_Last_5_Wins,H2H_Home_Wins,H2H_Home_Losses,H2H_Away_Wins,H2H_Away_Losses,H2H_Draws
2012,2012-06-04, Elman FC , Badbaado FC ,3,1,2,-2,Win,0,0,0,0,0,0,0
2012,2012-06-05, Sahafi FC , Jeenyo  FC ,1,1,0,0,Draw,0,0,0,0,0,0,0
2012,2012-06-07, Heegan S.C , Dekedda SC ,1,1,0,0,Draw,0,0,0,0,0,0,0
2012,2012-06-08, Mogadishu City Club , Horseed S.C ,1,1,0,0,Draw,0,0,0,0,0,0,0
2012,2012-06-11, Jeenyo  FC , Elman FC ,1,1,0,0,Draw,0,1,0,0,0,0,0
2012,2012-06-12, Badbaado FC , Dekedda SC ,2,3,-1,1,Loss,0,0,0,0,0,0,0
2012,2012-06-14, Sahafi FC , Horseed S.C ,1,1,0,0,Draw,0,0,0,0,0,0,0
2012,2012-06-15, Heegan S.C , Mogadishu City Club ,3,2,1,-1,Win,0,0,0,0,0,0,0
2012,2012-06-18, Elman FC , Dekedda SC ,4,0,4,-4,Win,1,1,0,0,0,0,0
2012,2012-06-19, Jeenyo  FC , Horseed S.C ,0,0,0,0,Draw,0,0,0,0,0,0,0
2012,2012-06-21, Badbaado FC , Mogadishu City Club ,0,3,-3,3,Loss,0,0,0,0,0,0,0
2012,2012-06-22, Sahafi FC , Heegan S.C ,0,1,-1,1,Loss,0,1,0,0,0,0,0
2012,2012-06-25, Horseed S.C , Elman FC ,1,3,-2,2,Loss,0,2,0,0,0,0,0
2012,2012-06-26, Dekedda SC , Mogadishu City Club ,1,1,0,0,Draw,1,1,0,0,0,0,0
2012,2012-06-28, Jeenyo  FC , Heegan S.C ,0,0,0,0,Draw,0,2,0,0,0,0,0
2012,2012-06-29, Badbaado FC , Sahafi FC ,0,1,-1,1,Loss,0,0,0,0,0,0,0
2012,2012-07-02, Elman FC , Mogadishu City Club ,1,1,0,0,Draw,3,1,0,0,0,0,0
2012,2012-07-03, Horseed S.C , Heegan S.C ,2,2,0,0,Draw,0,2,0,0,0,0,0
2012,2012-07-04, Dekedda SC , Sahafi FC ,0,0,0,0,Draw,1,1,0,0,0,0,0
2012,2012-07-05, Jeenyo  FC , Badbaado FC ,4,0,4,-4,Win,0,0,0,0,0,0,0
2012,2012-07-06, Heegan S.C , Elman FC ,0,3,-3,3,Loss,2,3,0,0,0,0,0
2012,2012-07-09, Mogadishu City Club , Sahafi FC ,1,0,1,-1,Win,1,1,0,0,0,0,0
2012,2012-07-10, Horseed S.C , Badbaado FC ,2,0,2,-2,Win,0,0,0,0,0,0,0
2012,2012-07-11, Dekedda SC , Jeenyo  FC ,1,1,0,0,Draw,1,1,0,0,0,0,0
2012,2012-07-12, Elman FC , Sahafi FC ,2,1,1,-1,Win,3,1,0,0,0,0,0
2012,2012-07-13, Heegan S.C , Badbaado FC ,3,1,2,-2,Win,2,0,0,0,0,0,0
2012,2012-07-16, Mogadishu City Club , Jeenyo  FC ,1,1,0,0,Draw,2,1,0,0,0,0,0
2012,2012-07-17, Horseed S.C , Dekedda SC ,2,1,1,-1,Win,1,1,0,0,0,0,0
2012,2012-09-27, Badbaado FC , Elman FC ,2,5,-3,3,Loss,0,4,0,1,1,0,0
2012,2012-09-28, Jeenyo  FC , Sahafi FC ,1,1,0,0,Draw,1,1,0,0,0,0,1
2012,2012-09-29, Dekedda SC , Heegan S.C ,2,4,-2,2,Loss,0,2,0,0,0,0,1
2012,2012-09-30, Horseed S.C , Mogadishu City Club ,0,2,-2,2,Loss,2,2,0,0,0,0,1
2012,2012-10-02, Elman FC , Jeenyo  FC ,1,2,-1,1,Loss,4,1,0,0,0,0,1
2012,2012-10-03, Dekedda SC , Badbaado FC ,5,1,4,-4,Win,0,0,0,0,0,0,0
2012,2012-10-04, Horseed S.C , Sahafi FC ,0,0,0,0,Draw,2,1,0,0,0,0,1
2012,2012-10-05, Mogadishu City Club , Heegan S.C ,1,1,0,0,Draw,2,2,0,1,1,0,0
2012,2012-10-08, Dekedda SC , Elman FC ,2,3,-1,1,Loss,1,3,0,1,1,0,0
2012,2012-10-09, Horseed S.C , Jeenyo  FC ,1,2,-1,1,Loss,2,2,0,0,0,0,1
2012,2012-10-10, Mogadishu City Club , Badbaado FC ,2,2,0,0,Draw,2,0,0,0,0,0,0
2012,2012-10-11, Heegan S.C , Sahafi FC ,2,0,2,-2,Win,2,0,0,0,0,0,0
2012,2012-10-12, Elman FC , Horseed S.C ,2,0,2,-2,Win,4,2,0,0,0,0,0
2012,2012-10-15, Mogadishu City Club , Dekedda SC ,1,2,-1,1,Loss,2,1,0,0,0,0,1
2012,2012-10-16, Heegan S.C , Jeenyo  FC ,0,1,-1,1,Loss,3,2,0,0,0,0,1
2012,2012-10-17, Sahafi FC , Badbaado FC ,2,1,1,-1,Win,0,0,0,0,0,0,0
2012,2012-10-18, Mogadishu City Club , Elman FC ,1,2,-1,1,Loss,1,4,0,0,0,0,1
2012,2012-10-19, Heegan S.C , Horseed S.C ,1,0,1,-1,Win,3,1,0,0,0,0,1
2012,2012-10-22, Sahafi FC , Dekedda SC ,0,0,0,0,Draw,1,2,0,0,0,0,1
2012,2012-10-23, Badbaado FC , Jeenyo  FC ,1,3,-2,2,Loss,0,3,0,1,1,0,0
2012,2012-10-24, Elman FC , Heegan S.C ,1,3,-2,2,Loss,4,3,0,0,0,0,0
2012,2012-10-25, Sahafi FC , Mogadishu City Club ,0,0,0,0,Draw,1,1,0,1,1,0,0
2012,2012-10-26, Badbaado FC , Horseed S.C ,0,1,-1,1,Loss,0,0,0,1,1,0,0
2012,2012-10-27, Jeenyo  FC , Dekedda SC ,1,1,0,0,Draw,4,2,0,0,0,0,1
2012,2012-10-28, Sahafi FC , Elman FC ,0,2,-2,2,Loss,1,3,0,1,1,0,0
2012,2012-10-29, Badbaado FC , Heegan S.C ,0,3,-3,3,Loss,0,3,0,1,1,0,0
2012,2012-10-30, Jeenyo  FC , Mogadishu City Club ,1,0,1,-1,Win,4,0,0,0,0,0,1
2012,2012-10-31, Dekedda SC , Horseed S.C ,2,2,0,0,Draw,2,1,0,1,1,0,0
2013,2013-04-19, Albeder , Ummah Hospital ,0,0,0,0,Draw,0,0,0,0,0,0,0
2013,2013-04-21, Geeska Afrika FC , Midnimo FC ,2,1,1,-1,Win,0,0,0,0,0,0,0
2013,2013-04-22, Sahafi FC , Badbaado FC ,1,0,1,-1,Win,1,0,1,0,0,1,0
2013,2013-04-23, Bariga Dhexe , Jazeera SC ,2,1,1,-1,Win,0,0,0,0,0,0,0
2013,2013-04-24, SomaliFruit FC , Gantaalaha Afgooye FC ,2,0,2,-2,Win,0,0,0,0,0,0,0
2013,2013-04-25, Waxool FC , ,6,0,6,-6,Win,0,0,0,0,0,0,0
2013,2013-04-26, Madbacadda FC , ,0,0,0,0,Draw,0,0,0,0,0,0,0
2013,2013-04-28, Raadsan FC , Gasko FC ,4,2,2,-2,Win,0,0,0,0,0,0,0
2013,2013-04-29, Badbaado FC , Albeder ,1,1,0,0,Draw,0,0,0,0,0,0,0
2013,2013-04-30, Jamhuuriya FC , Jazeera SC ,2,3,-1,1,Loss,0,0,0,0,0,0,0
2013,2013-05-01, Ummah Hospital , Gantaalaha Afgooye FC ,2,1,1,-1,Win,0,0,0,0,0,0,0
2013,2013-05-02, Geeska Afrika FC , ,2,1,1,-1,Win,1,0,0,0,0,0,0
2013,2013-05-03, Sahafi FC , ,2,2,0,0,Draw,2,0,0,0,0,0,0
2013,2013-05-05, Bariga Dhexe , Gasko FC ,6,0,6,-6,Win,1,0,0,0,0,0,0
2013,2013-05-06, SomaliFruit FC , Madbacadda FC ,2,3,-1,1,Loss,1,0,0,0,0,0,0
2013,2013-05-07, Waxool FC , Raadsan FC ,1,1,0,0,Draw,1,1,0,0,0,0,0
2013,2013-05-08, Albeder , Gantaalaha Afgooye FC ,3,2,1,-1,Win,0,0,0,0,0,0,0
2013,2013-05-09, Midnimo FC , ,2,0,2,-2,Win,0,0,0,0,0,0,0
2013,2013-05-10, Badbaado FC , ,0,1,-1,1,Loss,0,0,0,0,0,0,0
2013,2013-05-12, Jamhuuriya FC , Gasko FC ,1,0,1,-1,Win,0,0,0,0,0,0,0
2013,2013-05-13, Ummah Hospital , Madbacadda FC ,2,0,2,-2,Win,1,1,0,0,0,0,0
2013,2013-05-14, Geeska Afrika FC , Raadsan FC ,1,2,-1,1,Loss,2,1,0,0,0,0,0
2013,2013-05-15, Sahafi FC , SomaliFruit FC ,3,1,2,-2,Win,1,1,0,0,0,0,0
2013,2013-05-16, Bariga Dhexe , Waxool FC ,1,1,0,0,Draw,2,1,0,0,0,0,0
2013,2013-05-17, , Albeder ,2,2,0,0,Draw,1,1,0,0,0,0,0
2013,2013-05-19, Jazeera SC , Gasko FC ,1,0,1,-1,Win,1,0,0,0,0,0,0
2013,2013-05-20, Gantaalaha Afgooye FC , Madbacadda FC ,1,0,1,-1,Win,0,1,0,0,0,0,0
2013,2013-05-21, Midnimo FC , Raadsan FC ,1,2,-1,1,Loss,1,2,0,0,0,0,0
2013,2013-05-22, Badbaado FC , SomaliFruit FC ,0,5,-5,5,Loss,0,1,0,0,0,0,0
2013,2013-05-23, Jamhuuriya FC , Waxool FC ,1,1,0,0,Draw,1,1,0,0,0,0,0
2013,2013-05-24, Ummah Hospital , Sahafi FC ,3,1,2,-2,Win,2,2,0,0,0,0,0
2013,2013-05-26, Geeska Afrika FC , Bariga Dhexe ,0,2,-2,2,Loss,2,2,0,0,0,0,0
2013,2013-05-27, Albeder , Madbacadda FC ,0,1,-1,1,Loss,1,1,0,0,0,0,0
2013,2013-05-28, , Raadsan FC ,0,1,-1,1,Loss,1,3,0,0,0,0,0
2013,2013-05-29, , SomaliFruit FC ,0,0,0,0,Draw,1,2,0,0,0,0,0
2013,2013-05-30, Jazeera SC , Waxool FC ,1,3,-2,2,Loss,2,1,0,0,0,0,0
2013,2013-05-31, Gantaalaha Afgooye FC , Sahafi FC ,0,3,-3,3,Loss,1,2,0,0,0,0,0
2013,2013-06-02, Midnimo FC , Bariga Dhexe ,1,0,1,-1,Win,1,3,0,0,0,0,0
2013,2013-06-03, Badbaado FC , Ummah Hospital ,1,1,0,0,Draw,0,3,0,0,0,0,0
2013,2013-06-04, Jamhuuriya FC , Geeska Afrika FC ,1,1,0,0,Draw,1,2,0,0,0,0,0
2013,2013-06-05, SomaliFruit FC , Albeder ,1,1,0,0,Draw,2,1,0,0,0,0,0
2013,2013-06-06, Gasko FC , Waxool FC ,2,5,-3,3,Loss,0,2,0,0,0,0,0
2013,2013-06-07, Madbacadda FC , Sahafi FC ,1,1,0,0,Draw,2,3,0,0,0,0,0
2013,2013-06-09, , Bariga Dhexe ,0,4,-4,4,Loss,1,3,0,0,0,0,0
2013,2013-06-10, , Ummah Hospital ,2,2,0,0,Draw,1,3,0,0,0,0,0
2013,2013-06-11, Jazeera SC , Geeska Afrika FC ,1,1,0,0,Draw,2,2,0,0,0,0,0
2013,2013-06-12, Gantaalaha Afgooye FC , Badbaado FC ,0,2,-2,2,Loss,1,0,0,0,0,0,0
2013,2013-06-13, Midnimo FC , Jamhuuriya FC ,1,1,0,0,Draw,2,1,0,0,0,0,0
2013,2013-06-14, Albeder , Sahafi FC ,0,3,-3,3,Loss,1,2,0,0,0,0,0
2013,2013-06-16, Raadsan FC , Bariga Dhexe ,1,2,-1,1,Loss,4,3,0,0,0,0,0
2013,2013-06-17, SomaliFruit FC , Ummah Hospital ,1,1,0,0,Draw,1,3,0,0,0,0,0
2013,2013-06-18, Gasko FC , Geeska Afrika FC ,4,2,2,-2,Win,0,1,0,0,0,0,0
2013,2013-06-19, Madbacadda FC , Badbaado FC ,1,2,-1,1,Loss,2,1,0,0,0,0,0
2013,2013-06-20, , Jamhuuriya FC ,1,2,-1,1,Loss,0,1,0,0,0,0,0
2013,2013-06-21, , Gantaalaha Afgooye FC ,1,1,0,0,Draw,0,1,0,0,0,0,0
2013,2013-06-24, Waxool FC , Geeska Afrika FC ,1,1,0,0,Draw,2,0,0,0,0,0,0
2013,2013-06-25, Raadsan FC , Jamhuuriya FC ,0,2,-2,2,Loss,3,2,0,0,0,0,0
2013,2013-06-26, Gasko FC , Midnimo FC ,0,0,0,0,Draw,1,2,0,0,0,0,0
2013,2013-06-27, , Jazeera SC ,0,3,-3,3,Loss,0,2,0,0,0,0,0
2013,2013-06-28, Bariga Dhexe , Jamhuuriya FC ,0,1,-1,1,Loss,3,2,0,0,0,0,0
2013,2013-06-30, Waxool FC , Midnimo FC ,3,0,3,-3,Win,2,2,0,0,0,0,0
2013,2013-07-01, Raadsan FC , Jazeera SC ,3,2,1,-1,Win,3,3,0,0,0,0,0
2013,2013-07-02, Gasko FC , ,4,1,3,-3,Win,1,0,0,0,0,0,0
2013,2013-07-03, Jazeera SC , Midnimo FC ,2,1,1,-1,Win,2,1,0,0,0,0,0
2013,2013-08-11, Midnimo FC , Geeska Afrika FC ,2,1,1,-1,Win,1,0,0,1,1,0,0
2013,2013-08-12, Ummah Hospital , Albeder ,2,2,0,0,Draw,2,1,0,0,0,0,1
2013,2013-08-13, Jazeera SC , Bariga Dhexe ,0,3,-3,3,Loss,2,3,0,1,1,0,0
2013,2013-08-14, Badbaado FC , Sahafi FC ,0,2,-2,2,Loss,2,3,0,2,2,0,0
2013,2013-08-15, , Waxool FC ,1,4,-3,3,Loss,0,3,0,1,1,0,0
2013,2013-08-16, Gantaalaha Afgooye FC , SomaliFruit FC ,1,0,1,-1,Win,1,1,0,1,1,0,0
2013,2013-08-18, Gasko FC , Raadsan FC ,2,1,1,-1,Win,2,3,0,1,1,0,0
2013,2013-08-19, , Madbacadda FC ,2,1,1,-1,Win,0,1,0,0,0,0,1
2013,2013-08-20, Jazeera SC , Jamhuuriya FC ,3,2,1,-1,Win,2,3,0,0,0,0,0
2013,2013-08-21, Albeder , Badbaado FC ,1,1,0,0,Draw,0,2,0,0,0,0,1
2013,2013-08-22, , Geeska Afrika FC ,2,2,0,0,Draw,1,0,0,1,1,0,0
2013,2013-08-23, Gantaalaha Afgooye FC , Ummah Hospital ,1,1,0,0,Draw,2,1,0,1,1,0,0
2013,2013-08-25, Gasko FC , Bariga Dhexe ,0,0,0,0,Draw,3,3,0,1,1,0,0
2013,2013-08-26, , Sahafi FC ,1,3,-2,2,Loss,1,3,0,0,0,0,1
2013,2013-08-27, Raadsan FC , Waxool FC ,2,1,1,-1,Win,2,4,0,0,0,0,1
2013,2013-08-28, Madbacadda FC , SomaliFruit FC ,0,3,-3,3,Loss,1,1,0,0,0,0,0
2013,2013-08-29, , Midnimo FC ,0,1,-1,1,Loss,1,1,0,1,1,0,0
2013,2013-08-30, Gantaalaha Afgooye FC , Albeder ,1,1,0,0,Draw,1,0,0,1,1,0,0
2013,2013-09-01, Gasko FC , Jamhuuriya FC ,1,2,-1,1,Loss,3,3,0,1,1,0,0
2013,2013-09-02, , Badbaado FC ,0,1,-1,1,Loss,1,2,0,0,0,0,0
2013,2013-09-03, Raadsan FC , Geeska Afrika FC ,1,1,0,0,Draw,2,0,0,0,0,0,0
2013,2013-09-04, Madbacadda FC , Ummah Hospital ,0,0,0,0,Draw,1,0,0,1,1,0,0
2013,2013-09-05, Waxool FC , Bariga Dhexe ,3,1,2,-2,Win,3,3,0,0,0,0,1
2013,2013-09-06, SomaliFruit FC , Sahafi FC ,1,3,-2,2,Loss,1,4,0,1,1,0,0
2013,2013-09-08, Gasko FC , Jazeera SC ,0,1,-1,1,Loss,2,3,0,1,1,0,0
2013,2013-09-09, Albeder , ,1,1,0,0,Draw,0,1,0,0,0,0,1
2013,2013-09-10, Raadsan FC , Midnimo FC ,0,0,0,0,Draw,2,2,0,0,0,0,0
2013,2013-09-11, Madbacadda FC , Gantaalaha Afgooye FC ,3,3,0,0,Draw,0,1,0,1,1,0,0
2013,2013-09-12, Waxool FC , Jamhuuriya FC ,0,0,0,0,Draw,3,4,0,0,0,0,1
2013,2013-09-13, SomaliFruit FC , Badbaado FC ,1,0,1,-1,Win,1,3,0,0,0,0,0
2013,2013-09-15, Bariga Dhexe , Geeska Afrika FC ,3,0,3,-3,Win,2,0,0,0,0,0,0
2013,2013-09-16, Sahafi FC , Ummah Hospital ,4,2,2,-2,Win,4,0,0,1,1,0,0
2013,2013-09-17, Raadsan FC , ,6,1,5,-5,Win,2,0,0,0,0,0,0
2013,2013-09-18, Madbacadda FC , Albeder ,1,2,-1,1,Loss,0,0,0,0,0,0,0
2013,2013-09-19, Waxool FC , Jazeera SC ,1,1,0,0,Draw,3,3,0,0,0,0,0
2013,2013-09-20, SomaliFruit FC , ,1,1,0,0,Draw,2,0,0,0,0,0,1
2013,2013-09-22, Bariga Dhexe , Midnimo FC ,6,0,6,-6,Win,2,2,0,1,1,0,0
2013,2013-09-23, Sahafi FC , Gantaalaha Afgooye FC ,1,2,-1,1,Loss,5,1,0,0,0,0,0
2013,2013-09-24, Geeska Afrika FC , Jamhuuriya FC ,1,3,-2,2,Loss,0,3,0,0,0,0,1
2013,2013-09-25, Ummah Hospital , Badbaado FC ,2,1,1,-1,Win,0,2,0,0,0,0,1
2013,2013-09-26, Waxool FC , Gasko FC ,3,1,2,-2,Win,2,2,0,0,0,0,0
2013,2013-09-27, Albeder , SomaliFruit FC ,2,3,-1,1,Loss,1,2,0,0,0,0,1
2013,2013-09-29, Bariga Dhexe , ,10,1,9,-9,Win,3,0,0,0,0,0,0
2013,2013-10-01, Geeska Afrika FC , Jazeera SC ,2,3,-1,1,Loss,0,3,0,0,0,0,1
2013,2013-10-02, Ummah Hospital , ,2,2,0,0,Draw,1,0,0,0,0,0,1
2013,2013-10-03, Jamhuuriya FC , Midnimo FC ,2,0,2,-2,Win,3,2,0,0,0,0,1
2013,2013-10-04, Badbaado FC , Gantaalaha Afgooye FC ,1,0,1,-1,Win,1,2,0,0,0,0,0
2013,2013-10-07, Sahafi FC , Albeder ,3,1,2,-2,Win,4,1,0,0,0,0,0
2013,2013-10-08, Bariga Dhexe , Raadsan FC ,2,1,1,-1,Win,3,2,0,0,0,0,0
2013,2013-10-09, Ummah Hospital , SomaliFruit FC ,2,3,-1,1,Loss,1,3,0,0,0,0,1
2013,2013-10-10, Geeska Afrika FC , Gasko FC ,3,0,3,-3,Win,0,1,0,1,1,0,0
2013,2013-10-11, Badbaado FC , Madbacadda FC ,0,2,-2,2,Loss,2,0,0,0,0,0,0
2013,2013-10-13, Jamhuuriya FC , ,8,0,8,-8,Win,3,0,0,0,0,0,0
2013,2013-10-14, Gantaalaha Afgooye FC , ,1,0,1,-1,Win,1,0,0,0,0,0,1
2013,2013-10-15, Midnimo FC , Jazeera SC ,2,2,0,0,Draw,2,3,0,1,1,0,0
2013,2013-10-16, Geeska Afrika FC , Waxool FC ,1,5,-4,4,Loss,1,2,0,0,0,0,1
2013,2013-10-17, Jamhuuriya FC , Raadsan FC ,0,1,-1,1,Loss,4,2,0,0,0,0,0
2013,2013-10-18, Midnimo FC , Gasko FC ,2,2,0,0,Draw,1,0,0,0,0,0,1
2013,2013-10-19, Jazeera SC , ,3,0,3,-3,Win,3,0,0,0,0,0,0
2013,2013-10-20, Jamhuuriya FC , Bariga Dhexe ,3,2,1,-1,Win,3,4,0,0,0,0,0
2013,2013-10-21, Midnimo FC , Waxool FC ,1,3,-2,2,Loss,0,3,0,1,1,0,0
2013,2013-10-22, Jazeera SC , Raadsan FC ,2,3,-1,1,Loss,3,2,0,1,1,0,0
2013,2013-10-23, , Gasko FC ,0,1,-1,1,Loss,0,0,0,1,1,0,0
2013,2013-11-08, Heegan S.C , Gaadiidka FC ,3,2,1,-1,Win,4,0,0,0,0,0,0
2013,2013-11-10, Horseed S.C , Dekedda SC ,0,3,-3,3,Loss,1,1,1,0,0,1,1
2013,2013-11-11, Jeenyo  FC , Batroolka FC ,2,0,2,-2,Win,4,0,0,0,0,0,0
2013,2013-11-12, Elman FC , Mogadishu City Club ,1,3,-2,2,Loss,4,0,0,0,0,0,1
2013,2013-11-14, Dekedda SC , Heegan S.C ,1,2,-1,1,Loss,2,4,0,0,0,0,1
2013,2013-11-15, Gaadiidka FC , Batroolka FC ,1,0,1,-1,Win,0,0,0,0,0,0,0
2013,2013-11-18, Horseed S.C , Mogadishu City Club ,2,2,0,0,Draw,1,1,0,0,0,0,1
2014,2014-01-01, Jeenyo  FC , Elman FC ,0,2,-2,2,Loss,4,3,0,0,0,0,1
2014,2014-01-02, Heegan S.C , Batroolka FC ,4,2,2,-2,Win,5,0,0,0,0,0,0
2014,2014-01-03, Dekedda SC , Mogadishu City Club ,2,4,-2,2,Loss,1,1,0,0,0,0,1
2014,2014-01-06, Gaadiidka FC , Elman FC ,0,3,-3,3,Loss,1,3,0,0,0,0,0
2014,2014-01-07, Horseed S.C , Jeenyo  FC ,2,4,-2,2,Loss,1,3,0,0,0,0,1
2014,2014-01-09, Mogadishu City Club , Heegan S.C ,1,0,1,-1,Win,2,5,0,1,1,0,1
2014,2014-01-10, Batroolka FC , Elman FC ,1,2,-1,1,Loss,0,3,0,0,0,0,0
2014,2014-01-13, Dekedda SC , Jeenyo  FC ,0,3,-3,3,Loss,1,3,0,0,0,0,2
2014,2014-01-14, Gaadiidka FC , Horseed S.C ,2,2,0,0,Draw,1,1,0,0,0,0,0
2014,2014-01-16, Heegan S.C , Elman FC ,1,2,-1,1,Loss,4,4,0,0,0,0,0
2014,2014-01-17, Mogadishu City Club , Jeenyo  FC ,1,1,0,0,Draw,3,4,0,1,1,0,1
2014,2014-01-20, Batroolka FC , Horseed S.C ,1,3,-2,2,Loss,0,0,0,0,0,0,0
2014,2014-01-21, Dekedda SC , Gaadiidka FC ,1,1,0,0,Draw,1,1,0,0,0,0,0
2014,2014-01-23, Jeenyo  FC , Heegan S.C ,0,1,-1,1,Loss,3,3,0,0,0,0,1
2014,2014-01-24, Elman FC , Horseed S.C ,3,3,0,0,Draw,4,1,1,0,0,1,0
2014,2014-01-27, Mogadishu City Club , Gaadiidka FC ,3,2,1,-1,Win,3,1,0,0,0,0,0
2014,2014-01-28, Batroolka FC , Dekedda SC ,0,1,-1,1,Loss,0,1,0,0,0,0,0
2014,2014-01-30, Jeenyo  FC , Gaadiidka FC ,2,0,2,-2,Win,2,1,0,0,0,0,0
2014,2014-01-31, Heegan S.C , Horseed S.C ,3,0,3,-3,Win,3,1,1,0,0,1,1
2014,2014-02-03, Elman FC , Dekedda SC ,2,0,2,-2,Win,4,1,1,0,0,1,0
2014,2014-02-04, Mogadishu City Club , Batroolka FC ,4,1,3,-3,Win,3,0,0,0,0,0,0
2014,2014-02-17, Gaadiidka FC , Heegan S.C ,1,2,-1,1,Loss,0,3,0,1,1,0,0
2014,2014-02-18, Dekedda SC , Horseed S.C ,0,1,-1,1,Loss,1,1,0,1,1,0,1
2014,2014-02-20, Jeenyo  FC , Batroolka FC ,1,1,0,0,Draw,3,0,1,0,0,1,0
2014,2014-02-21, Mogadishu City Club , Elman FC ,0,0,0,0,Draw,4,4,0,0,0,0,1
2014,2014-02-24, Heegan S.C , Dekedda SC ,1,2,-1,1,Loss,3,1,0,0,0,0,1
2014,2014-02-25, Batroolka FC , Gaadiidka FC ,0,2,-2,2,Loss,0,0,0,1,1,0,0
2014,2014-02-27, Mogadishu City Club , Horseed S.C ,2,0,2,-2,Win,3,2,0,0,0,0,2
2014,2014-02-28, Elman FC , Jeenyo  FC ,2,5,-3,3,Loss,3,2,0,0,0,0,1
2014,2014-03-03, Batroolka FC , Heegan S.C ,1,3,-2,2,Loss,0,3,0,1,1,0,0
2014,2014-03-04, Mogadishu City Club , Dekedda SC ,2,1,1,-1,Win,3,2,0,0,0,0,1
2014,2014-03-06, Elman FC , Gaadiidka FC ,3,1,2,-2,Win,2,1,0,0,0,0,0
2014,2014-03-07, Jeenyo  FC , Horseed S.C ,1,0,1,-1,Win,2,2,0,0,0,0,1
2014,2014-03-10, Heegan S.C , Mogadishu City Club ,0,2,-2,2,Loss,4,4,1,1,1,1,1
2014,2014-03-11, Elman FC , Batroolka FC ,8,0,8,-8,Win,2,0,0,0,0,0,0
2014,2014-03-13, Jeenyo  FC , Dekedda SC ,1,1,0,0,Draw,3,2,0,0,0,0,2
2014,2014-03-14, Horseed S.C , Gaadiidka FC ,3,2,1,-1,Win,1,1,0,0,0,0,1
2014,2014-03-20, Elman FC , Heegan S.C ,2,2,0,0,Draw,3,3,0,0,0,0,0
2014,2014-03-21, Jeenyo  FC , Mogadishu City Club ,1,1,0,0,Draw,3,4,1,0,0,1,2
2014,2014-03-24, Horseed S.C , Batroolka FC ,6,1,5,-5,Win,2,0,0,0,0,0,0
2014,2014-03-25, Gaadiidka FC , Dekedda SC ,0,0,0,0,Draw,1,1,0,0,0,0,1
2014,2014-03-27, Heegan S.C , Jeenyo  FC ,1,1,0,0,Draw,2,2,0,0,0,0,1
2014,2014-03-28, Horseed S.C , Elman FC ,1,1,0,0,Draw,3,2,0,1,1,0,1
2014,2014-03-31, Gaadiidka FC , Mogadishu City Club ,1,2,-1,1,Loss,1,3,0,1,1,0,0
2014,2014-04-01, Dekedda SC , Batroolka FC ,1,2,-1,1,Loss,1,0,0,0,0,0,0
2014,2014-04-03, Horseed S.C , Heegan S.C ,3,3,0,0,Draw,2,1,0,2,2,0,1
2014,2014-04-04, Gaadiidka FC , Jeenyo  FC ,3,1,2,-2,Win,1,2,0,1,1,0,0
2014,2014-04-05, Dekedda SC , Elman FC ,0,3,-3,3,Loss,1,2,0,2,2,0,0
2014,2014-04-06, Batroolka FC , Mogadishu City Club ,1,7,-6,6,Loss,1,4,0,1,1,0,0
2014,2014-10-12, Geeska Afrika FC , Gasko FC ,0,1,-1,1,Loss,1,1,1,1,1,1,0
2014,2014-10-14, , Jazeera SC ,2,6,-4,4,Loss,0,2,0,1,1,0,0
2014,2014-10-16, Jamhuuriya FC , Raadsan FC ,3,0,3,-3,Win,4,3,0,0,0,0,0
2014,2014-10-17, Midnimo FC , Gasko FC ,3,0,3,-3,Win,0,2,0,0,0,0,2
2014,2014-10-19, Geeska Afrika FC , Raadsan FC ,3,1,2,-2,Win,1,3,0,0,0,0,1
2014,2014-10-21, Jamhuuriya FC , ,6,2,4,-4,Win,4,0,1,0,0,1,0
2014,2014-10-23, Jazeera SC , Midnimo FC ,2,3,-1,1,Loss,3,1,1,0,0,1,1
2014,2014-10-24, Gasko FC , Raadsan FC ,0,4,-4,4,Loss,2,2,1,1,1,1,0
2014,2014-10-26, Geeska Afrika FC , ,2,1,1,-1,Win,2,0,1,0,0,1,1
2014,2014-10-28, Midnimo FC , Raadsan FC ,4,3,1,-1,Win,2,3,0,0,0,0,1
2014,2014-10-30, Jazeera SC , Jamhuuriya FC ,1,2,-1,1,Loss,2,4,1,0,0,1,0
2014,2014-10-31, Gasko FC , ,1,0,1,-1,Win,2,0,1,0,0,1,0
2014,2014-11-02, Jamhuuriya FC , Midnimo FC ,1,1,0,0,Draw,4,3,1,0,0,1,1
2014,2014-11-04, Raadsan FC , ,2,1,1,-1,Win,2,0,1,0,0,1,0
2014,2014-11-06, Jazeera SC , Geeska Afrika FC ,3,2,1,-1,Win,2,3,0,0,0,0,1
2014,2014-11-07, Midnimo FC , ,5,0,5,-5,Win,3,0,1,0,0,1,0
2014,2014-11-09, Jamhuuriya FC , Geeska Afrika FC ,1,3,-2,2,Loss,4,2,0,0,0,0,1
2014,2014-11-11, Jazeera SC , Gasko FC ,2,0,2,-2,Win,2,3,1,0,0,1,0
2014,2014-11-13, Geeska Afrika FC , Midnimo FC ,3,2,1,-1,Win,3,4,1,1,1,1,0
2014,2014-11-14, Jamhuuriya FC , Gasko FC ,3,1,2,-2,Win,3,2,1,0,0,1,0
2014,2014-11-16, Raadsan FC , Jazeera SC ,1,2,-1,1,Loss,2,3,1,0,0,1,0
2014,2014-11-18, Gasko FC , Geeska Afrika FC ,2,1,1,-1,Win,1,4,1,1,1,1,0
2014,2014-11-20, Jazeera SC , ,1,1,0,0,Draw,3,0,1,0,0,1,0
2014,2014-11-21, Raadsan FC , Jamhuuriya FC ,3,2,1,-1,Win,2,3,0,1,1,0,0
2014,2014-11-23, Gasko FC , Midnimo FC ,0,5,-5,5,Loss,2,3,0,1,1,0,2
2014,2014-11-25, Raadsan FC , Geeska Afrika FC ,3,1,2,-2,Win,3,3,0,1,1,0,1
2014,2014-11-27, Jamhuuriya FC , ,0,0,0,0,Draw,2,0,2,0,0,2,0
2014,2014-11-28, Midnimo FC , Jazeera SC ,2,2,0,0,Draw,3,3,0,1,1,0,1
2014,2014-11-30, Raadsan FC , Gasko FC ,3,2,1,-1,Win,3,2,1,1,1,1,0
2014,2014-12-02, , Geeska Afrika FC ,1,3,-2,2,Loss,0,2,0,2,2,0,1
2014,2014-12-04, Raadsan FC , Midnimo FC ,1,7,-6,6,Loss,4,2,0,1,1,0,1
2014,2014-12-05, Jamhuuriya FC , Jazeera SC ,2,3,-1,1,Loss,1,3,0,1,1,0,0
2014,2014-12-07, , Gasko FC ,2,2,0,0,Draw,0,1,0,2,2,0,0
2014,2014-12-09, Midnimo FC , Jamhuuriya FC ,9,2,7,-7,Win,3,1,0,1,1,0,2
2014,2014-12-11, , Raadsan FC ,3,4,-1,1,Loss,0,3,0,2,2,0,0
2014,2014-12-12, Geeska Afrika FC , Jazeera SC ,1,3,-2,2,Loss,3,3,0,1,1,0,1
2014,2014-12-14, , Midnimo FC ,1,12,-11,11,Loss,0,3,0,2,2,0,0
2014,2014-12-16, Geeska Afrika FC , Jamhuuriya FC ,2,1,1,-1,Win,2,1,0,0,0,0,1
2014,2014-12-18, Gasko FC , Jazeera SC ,0,1,-1,1,Loss,1,3,0,2,2,0,0
2014,2014-12-19, Midnimo FC , Geeska Afrika FC ,5,2,3,-3,Win,4,2,1,2,2,1,0
2014,2014-12-19, Horseed S.C , Elman FC ,2,3,-1,1,Loss,2,3,0,1,1,0,2
2014,2014-12-20, Gasko FC , Jamhuuriya FC ,4,1,3,-3,Win,1,0,0,2,2,0,0
2014,2014-12-21, Jazeera SC , Raadsan FC ,0,2,-2,2,Loss,3,4,0,1,1,0,0
2014,2014-12-21, Jeenyo  FC , Heegan S.C ,1,3,-2,2,Loss,1,1,0,0,0,0,2
2014,2014-12-22, SomaliFruit FC , Dekedda SC ,3,1,2,-2,Win,3,0,0,0,0,0,0
2014,2014-12-23, Mogadishu City Club , Gaadiidka FC ,1,1,0,0,Draw,4,1,1,0,0,1,0
2014,2014-12-25, Batroolka FC , Sahafi FC ,2,3,-1,1,Loss,1,4,0,0,0,0,0
2014,2014-12-26, Heegan S.C , Horseed S.C ,4,0,4,-4,Win,1,2,2,0,0,2,2
2014,2014-12-29, Elman FC , Dekedda SC ,1,1,0,0,Draw,3,0,2,0,0,2,0
2014,2014-12-30, Jeenyo  FC , Gaadiidka FC ,4,2,2,-2,Win,0,1,1,1,1,1,0
2015,2015-01-01, Sahafi FC , SomaliFruit FC ,2,0,2,-2,Win,4,4,1,0,0,1,0
2015,2015-01-02, Mogadishu City Club , Batroolka FC ,3,0,3,-3,Win,3,1,1,0,0,1,0
2015,2015-01-05, Horseed S.C , Dekedda SC ,0,1,-1,1,Loss,1,0,1,0,0,1,1
2015,2015-01-06, Heegan S.C , Gaadiidka FC ,1,0,1,-1,Win,2,1,1,0,0,1,0
2015,2015-01-08, Elman FC , Sahafi FC ,0,2,-2,2,Loss,2,4,1,0,0,1,0
2015,2015-01-09, Jeenyo  FC , Batroolka FC ,4,1,3,-3,Win,1,1,1,0,0,1,1
2015,2015-01-12, SomaliFruit FC , Mogadishu City Club ,1,2,-1,1,Loss,3,3,0,0,0,0,0
2015,2015-01-15, Gaadiidka FC , Horseed S.C ,0,1,-1,1,Loss,1,0,0,1,1,0,1
2015,2015-01-16, Dekedda SC , Sahafi FC ,2,1,1,-1,Win,1,4,0,0,0,0,2
2015,2015-01-19, Batroolka FC , Heegan S.C ,0,4,-4,4,Loss,1,3,0,1,1,0,0
2015,2015-01-22, Mogadishu City Club , Elman FC ,1,1,0,0,Draw,4,2,0,0,0,0,2
2015,2015-01-23, Jeenyo  FC , SomaliFruit FC ,5,0,5,-5,Win,2,3,0,0,0,0,0
2015,2015-01-26, Horseed S.C , Sahafi FC ,2,1,1,-1,Win,1,4,0,0,0,0,2
2015,2015-01-27, Gaadiidka FC , Batroolka FC ,3,0,3,-3,Win,1,0,1,0,0,1,0
2015,2015-01-29, Dekedda SC , Mogadishu City Club ,0,2,-2,2,Loss,2,3,0,1,1,0,1
2015,2015-01-30, SomaliFruit FC , Heegan S.C ,1,8,-7,7,Loss,2,4,0,0,0,0,0
2015,2015-02-02, Elman FC , Jeenyo  FC ,1,1,0,0,Draw,2,3,0,0,0,0,1
2015,2015-02-05, Batroolka FC , Horseed S.C ,2,2,0,0,Draw,0,2,0,1,1,0,0
2015,2015-02-06, Sahafi FC , Mogadishu City Club ,0,0,0,0,Draw,3,3,0,1,1,0,1
2015,2015-02-19, Dekedda SC , Jeenyo  FC ,0,1,-1,1,Loss,2,3,0,0,0,0,3
2015,2015-02-20, Elman FC , Heegan S.C ,1,0,1,-1,Win,1,5,0,0,0,0,1
2015,2015-02-22, Horseed S.C , Mogadishu City Club ,0,2,-2,2,Loss,2,3,0,1,1,0,2
2015,2015-02-23, Batroolka FC , SomaliFruit FC ,1,2,-1,1,Loss,0,1,0,0,0,0,0
2015,2015-02-24, Sahafi FC , Jeenyo  FC ,0,0,0,0,Draw,2,4,0,0,0,0,2
2015,2015-02-26, Gaadiidka FC , Elman FC ,0,0,0,0,Draw,1,1,0,1,1,0,0
2015,2015-02-27, Dekedda SC , Heegan S.C ,0,2,-2,2,Loss,2,4,0,0,0,0,1
2015,2015-03-01, SomaliFruit FC , Horseed S.C ,2,0,2,-2,Win,1,2,0,0,0,0,0
2015,2015-03-03, Batroolka FC , Elman FC ,1,3,-2,2,Loss,0,1,0,1,1,0,0
2015,2015-03-04, Mogadishu City Club , Jeenyo  FC ,0,3,-3,3,Loss,3,3,0,1,1,0,3
2015,2015-03-05, Sahafi FC , Heegan S.C ,3,3,0,0,Draw,1,4,0,1,1,0,0
2015,2015-03-06, Gaadiidka FC , Dekedda SC ,0,1,-1,1,Loss,1,2,0,0,0,0,2
2015,2015-03-08, Horseed S.C , Jeenyo  FC ,0,1,-1,1,Loss,2,3,0,1,1,0,1
2015,2015-03-09, SomaliFruit FC , Elman FC ,0,2,-2,2,Loss,2,2,0,0,0,0,0
2015,2015-03-10, Mogadishu City Club , Heegan S.C ,0,0,0,0,Draw,2,3,1,1,1,1,1
2015,2015-03-12, Batroolka FC , Dekedda SC ,0,4,-4,4,Loss,0,2,0,0,0,0,0
2015,2015-03-13, Sahafi FC , Gaadiidka FC ,0,1,-1,1,Loss,0,1,0,0,0,0,0
2015,2015-03-19, Elman FC , Horseed S.C ,3,0,3,-3,Win,3,1,1,0,0,1,2
2015,2015-03-20, Heegan S.C , Jeenyo  FC ,2,0,2,-2,Win,2,3,0,0,0,0,2
2015,2015-03-22, Dekedda SC , SomaliFruit FC ,0,1,-1,1,Loss,2,2,0,1,1,0,0
2015,2015-03-23, Gaadiidka FC , Mogadishu City Club ,2,1,1,-1,Win,2,2,0,1,1,0,1
2015,2015-03-24, Sahafi FC , Batroolka FC ,7,0,7,-7,Win,0,0,0,0,0,0,0
2015,2015-03-26, Horseed S.C , Heegan S.C ,1,0,1,-1,Win,0,2,0,3,3,0,2
2015,2015-03-27, Dekedda SC , Elman FC ,2,0,2,-2,Win,2,4,0,2,2,0,1
2015,2015-03-29, Gaadiidka FC , Jeenyo  FC ,4,2,2,-2,Win,3,3,1,2,2,1,0
2015,2015-03-30, SomaliFruit FC , Sahafi FC ,1,4,-3,3,Loss,3,1,0,2,2,0,0
2015,2015-04-02, Dekedda SC , Horseed S.C ,4,0,4,-4,Win,3,1,0,1,1,0,1
2015,2015-04-03, Gaadiidka FC , Heegan S.C ,0,1,-1,1,Loss,3,2,0,2,2,0,0
2015,2015-04-05, Sahafi FC , Elman FC ,1,3,-2,2,Loss,2,3,0,1,1,0,0
2015,2015-04-07, Mogadishu City Club , SomaliFruit FC ,2,0,2,-2,Win,1,3,0,0,0,0,0
2015,2015-04-08, Batroolka FC , Jeenyo  FC ,1,8,-7,7,Loss,0,2,0,2,2,0,1
2015,2015-04-09, Horseed S.C , Gaadiidka FC ,1,3,-2,2,Loss,1,3,1,0,0,1,1
2015,2015-04-10, Sahafi FC , Dekedda SC ,1,3,-2,2,Loss,2,4,0,1,1,0,2
2015,2015-04-12, Heegan S.C , Batroolka FC ,4,1,3,-3,Win,2,0,1,0,0,1,0
2015,2015-04-13, Elman FC , Mogadishu City Club ,0,0,0,0,Draw,4,2,0,0,0,0,3
2015,2015-04-14, SomaliFruit FC , Jeenyo  FC ,1,1,0,0,Draw,2,3,0,1,1,0,0
2015,2015-04-16, Sahafi FC , Horseed S.C ,0,0,0,0,Draw,2,1,0,1,1,0,2
2015,2015-04-17, Batroolka FC , Gaadiidka FC ,0,0,0,0,Draw,0,4,0,2,2,0,0
2015,2015-04-30, Batroolka FC , Mogadishu City Club ,1,5,-4,4,Loss,0,1,0,2,2,0,0
2015,2015-05-13, Mogadishu City Club , Dekedda SC ,0,1,-1,1,Loss,2,4,1,0,0,1,1
2015,2015-05-14, Heegan S.C , SomaliFruit FC ,3,0,3,-3,Win,3,1,0,0,0,0,0
2015,2015-05-15, Jeenyo  FC , Elman FC ,0,0,0,0,Draw,2,3,0,0,0,0,2
2015,2015-05-17, Horseed S.C , Batroolka FC ,3,1,2,-2,Win,1,0,1,0,0,1,1
2015,2015-05-18, Mogadishu City Club , Sahafi FC ,3,0,3,-3,Win,2,2,1,0,0,1,2
2015,2015-05-19, SomaliFruit FC , Gaadiidka FC ,1,0,1,-1,Win,1,3,0,0,0,0,0
2015,2015-05-21, Jeenyo  FC , Dekedda SC ,3,0,3,-3,Win,1,4,0,0,0,0,3
2015,2015-05-22, Heegan S.C , Elman FC ,1,1,0,0,Draw,4,2,0,1,1,0,1
2015,2015-05-24, Mogadishu City Club , Horseed S.C ,5,0,5,-5,Win,3,2,1,0,0,1,2
2015,2015-05-25, SomaliFruit FC , Batroolka FC ,1,2,-1,1,Loss,1,0,0,0,0,0,0
2015,2015-05-26, Jeenyo  FC , Sahafi FC ,2,1,1,-1,Win,2,1,0,0,0,0,3
2015,2015-05-28, Elman FC , Gaadiidka FC ,0,2,-2,2,Loss,1,2,1,0,0,1,1
2015,2015-05-29, Heegan S.C , Dekedda SC ,2,0,2,-2,Win,3,4,0,0,0,0,1
2015,2015-05-31, Horseed S.C , SomaliFruit FC ,2,0,2,-2,Win,1,1,0,1,1,0,0
2015,2015-06-01, Jeenyo  FC , Mogadishu City Club ,1,2,-1,1,Loss,3,3,1,0,0,1,3
2015,2015-06-02, Elman FC , Batroolka FC ,4,2,2,-2,Win,1,1,1,0,0,1,0
2015,2015-06-04, Heegan S.C , Sahafi FC ,0,1,-1,1,Loss,4,0,1,0,0,1,1
2015,2015-06-05, Dekedda SC , Gaadiidka FC ,2,0,2,-2,Win,3,2,0,0,0,0,2
2015,2015-06-07, Jeenyo  FC , Horseed S.C ,2,1,1,-1,Win,2,2,1,0,0,1,1
2015,2015-06-08, Elman FC , SomaliFruit FC ,2,2,0,0,Draw,1,1,0,0,0,0,0
2015,2015-06-09, Heegan S.C , Mogadishu City Club ,0,2,-2,2,Loss,3,4,1,1,1,1,2
2015,2015-06-11, Dekedda SC , Batroolka FC ,5,1,4,-4,Win,3,1,0,0,0,0,0
2015,2015-06-12, Gaadiidka FC , Sahafi FC ,2,1,1,-1,Win,2,1,0,0,0,0,0
2015,2015-12-28, Dekedda SC , Heegan S.C ,1,0,1,-1,Win,3,2,0,1,1,0,1
2015,2015-12-29, Mogadishu City Club , Waxool FC ,1,0,1,-1,Win,4,3,0,0,0,0,0
2015,2015-12-30, Jeenyo  FC , Horseed S.C ,1,1,0,0,Draw,3,2,2,0,0,2,1
2015,2015-12-31, Gaadiidka FC , Sahafi FC ,1,1,0,0,Draw,2,1,1,0,0,1,0
2016,2016-01-01, Elman FC , Badbaado FC ,1,1,0,0,Draw,1,2,1,0,0,1,0
2016,2016-01-04, Waxool FC , Dekedda SC ,0,0,0,0,Draw,3,3,0,0,0,0,0
2016,2016-01-05, Heegan S.C , Horseed S.C ,2,2,0,0,Draw,1,2,3,1,1,3,2
2016,2016-01-06, Mogadishu City Club , Sahafi FC ,1,0,1,-1,Win,5,1,2,0,0,2,2
2016,2016-01-07, Jeenyo  FC , Badbaado FC ,4,1,3,-3,Win,3,1,1,0,0,1,0
2016,2016-01-08, Gaadiidka FC , Elman FC ,0,1,-1,1,Loss,2,1,0,1,1,0,1
2016,2016-01-11, Dekedda SC , Horseed S.C ,2,0,2,-2,Win,3,1,1,1,1,1,1
2016,2016-01-12, Waxool FC , Sahafi FC ,2,1,1,-1,Win,3,1,0,0,0,0,0
2016,2016-01-13, Heegan S.C , Badbaado FC ,1,0,1,-1,Win,1,1,1,0,0,1,0
2016,2016-01-14, Mogadishu City Club , Elman FC ,2,1,1,-1,Win,5,2,0,0,0,0,4
2016,2016-01-15, Jeenyo  FC , Gaadiidka FC ,1,1,0,0,Draw,3,2,2,2,2,2,0
2016,2016-01-18, Sahafi FC , Dekedda SC ,1,4,-3,3,Loss,1,4,0,1,1,0,2
2016,2016-01-19, Horseed S.C , Badbaado FC ,2,0,2,-2,Win,1,1,1,0,0,1,0
2016,2016-01-20, Waxool FC , Elman FC ,0,4,-4,4,Loss,3,2,0,0,0,0,0
2016,2016-01-21, Heegan S.C , Gaadiidka FC ,0,1,-1,1,Loss,1,1,2,0,0,2,0
2016,2016-01-22, Mogadishu City Club , Jeenyo  FC ,2,0,2,-2,Win,5,2,0,1,1,0,3
2016,2016-01-25, Dekedda SC , Badbaado FC ,2,2,0,0,Draw,4,0,1,0,0,1,0
2016,2016-01-26, Sahafi FC , Elman FC ,2,0,2,-2,Win,0,2,0,1,1,0,0
2016,2016-01-27, Horseed S.C , Gaadiidka FC ,0,2,-2,2,Loss,1,2,1,0,0,1,1
2016,2016-01-28, Waxool FC , Jeenyo  FC ,1,2,-1,1,Loss,2,2,0,0,0,0,0
2016,2016-01-29, Heegan S.C , Mogadishu City Club ,0,0,0,0,Draw,1,5,1,1,1,1,2
2016,2016-02-01, Elman FC , Dekedda SC ,0,1,-1,1,Loss,2,3,2,1,1,2,1
2016,2016-02-02, Badbaado FC , Gaadiidka FC ,0,2,-2,2,Loss,0,2,0,0,0,0,0
2016,2016-02-03, Sahafi FC , Jeenyo  FC ,1,3,-2,2,Loss,1,2,0,1,1,0,3
2016,2016-02-04, Horseed S.C , Mogadishu City Club ,0,0,0,0,Draw,1,4,0,2,2,0,2
2016,2016-02-05, Waxool FC , Heegan S.C ,0,2,-2,2,Loss,1,1,0,0,0,0,0
2016,2016-02-08, Dekedda SC , Gaadiidka FC ,1,1,0,0,Draw,3,3,1,0,0,1,2
2016,2016-02-09, Elman FC , Jeenyo  FC ,1,1,0,0,Draw,2,3,0,0,0,0,3
2016,2016-02-10, Badbaado FC , Mogadishu City Club ,0,6,-6,6,Loss,0,3,0,0,0,0,1
2016,2016-02-11, Sahafi FC , Heegan S.C ,0,2,-2,2,Loss,1,2,0,1,1,0,1
2016,2016-02-12, Horseed S.C , Waxool FC ,3,1,2,-2,Win,1,1,0,0,0,0,0
2016,2016-02-15, Jeenyo  FC , Dekedda SC ,3,1,2,-2,Win,2,3,1,0,0,1,3
2016,2016-02-16, Gaadiidka FC , Mogadishu City Club ,0,2,-2,2,Loss,3,3,1,1,1,1,1
2016,2016-02-17, Elman FC , Heegan S.C ,1,1,0,0,Draw,1,3,1,0,0,1,2
2016,2016-02-18, Badbaado FC , Waxool FC ,1,4,-3,3,Loss,0,1,0,0,0,0,0
2016,2016-02-19, Sahafi FC , Horseed S.C ,2,3,-1,1,Loss,1,2,0,1,1,0,3
2016,2016-02-22, Dekedda SC , Mogadishu City Club ,1,1,0,0,Draw,2,3,0,1,1,0,1
2016,2016-02-23, Jeenyo  FC , Heegan S.C ,2,2,0,0,Draw,3,2,0,1,1,0,2
2016,2016-02-24, Gaadiidka FC , Waxool FC ,2,1,1,-1,Win,3,1,0,0,0,0,0
2016,2016-02-25, Elman FC , Horseed S.C ,0,3,-3,3,Loss,1,3,2,0,0,2,2
2016,2016-02-26, Badbaado FC , Sahafi FC ,2,3,-1,1,Loss,0,1,0,2,2,0,0
2016,2016-03-03, Heegan S.C , Dekedda SC ,3,0,3,-3,Win,2,1,1,1,1,1,1
2016,2016-03-04, Waxool FC , Mogadishu City Club ,1,2,-1,1,Loss,1,2,0,1,1,0,0
2016,2016-03-07, Horseed S.C , Jeenyo  FC ,1,3,-2,2,Loss,3,3,0,2,2,0,2
2016,2016-03-08, Sahafi FC , Gaadiidka FC ,1,1,0,0,Draw,2,3,0,1,1,0,1
2016,2016-03-09, Badbaado FC , Elman FC ,1,2,-1,1,Loss,0,0,0,1,1,0,1
2016,2016-03-10, Dekedda SC , Waxool FC ,2,1,1,-1,Win,1,1,0,0,0,0,1
2016,2016-03-11, Horseed S.C , Heegan S.C ,1,2,-1,1,Loss,3,3,1,3,3,1,3
2016,2016-03-14, Sahafi FC , Mogadishu City Club ,0,6,-6,6,Loss,1,3,0,3,3,0,2
2016,2016-03-15, Badbaado FC , Jeenyo  FC ,0,7,-7,7,Loss,0,3,0,2,2,0,0
2016,2016-03-16, Elman FC , Gaadiidka FC ,0,1,-1,1,Loss,1,2,1,0,0,1,1
2016,2016-03-17, Horseed S.C , Dekedda SC ,2,2,0,0,Draw,3,1,1,2,2,1,1
2016,2016-03-18, Sahafi FC , Waxool FC ,1,1,0,0,Draw,1,1,0,1,1,0,0
2016,2016-03-21, Badbaado FC , Heegan S.C ,1,8,-7,7,Loss,0,3,0,2,2,0,0
2016,2016-03-22, Elman FC , Mogadishu City Club ,1,1,0,0,Draw,1,4,0,1,1,0,4
2016,2016-03-23, Gaadiidka FC , Jeenyo  FC ,1,2,-1,1,Loss,2,3,2,2,2,2,1
2016,2016-03-24, Dekedda SC , Sahafi FC ,4,1,3,-3,Win,1,1,1,0,0,1,2
2016,2016-03-25, Badbaado FC , Horseed S.C ,2,3,-1,1,Loss,0,2,0,2,2,0,0
2016,2016-03-28, Elman FC , Waxool FC ,3,0,3,-3,Win,1,1,0,0,0,0,0
2016,2016-03-29, Gaadiidka FC , Heegan S.C ,0,0,0,0,Draw,2,3,0,2,2,0,0
2016,2016-04-08, Jeenyo  FC , Mogadishu City Club ,2,3,-1,1,Loss,4,3,1,1,1,1,3
2016,2016-04-11, Badbaado FC , Dekedda SC ,0,2,-2,2,Loss,0,2,0,1,1,0,1
2016,2016-04-12, Elman FC , Sahafi FC ,2,1,1,-1,Win,2,1,1,1,1,1,0
2016,2016-04-13, Gaadiidka FC , Horseed S.C ,0,0,0,0,Draw,2,2,0,1,1,0,1
2016,2016-04-14, Jeenyo  FC , Waxool FC ,4,1,3,-3,Win,3,0,0,0,0,0,0
2016,2016-04-15, Mogadishu City Club , Heegan S.C ,1,1,0,0,Draw,3,3,1,1,1,1,3
2016,2016-04-26, Dekedda SC , Elman FC ,3,0,3,-3,Win,3,3,1,2,2,1,1
2016,2016-04-27, Gaadiidka FC , Badbaado FC ,2,0,2,-2,Win,1,0,0,0,0,0,0
2016,2016-04-28, Jeenyo  FC , Sahafi FC ,1,0,1,-1,Win,4,0,1,0,0,1,3
2016,2016-04-29, Mogadishu City Club , Horseed S.C ,2,0,2,-2,Win,3,1,2,0,0,2,3
2016,2016-04-30, Heegan S.C , Waxool FC ,4,1,3,-3,Win,3,0,0,0,0,0,0
2016,2016-05-01, Gaadiidka FC , Dekedda SC ,0,1,-1,1,Loss,2,4,0,1,1,0,3
2016,2016-05-02, Jeenyo  FC , Elman FC ,0,0,0,0,Draw,4,2,0,0,0,0,4
2016,2016-05-03, Mogadishu City Club , Badbaado FC ,4,0,4,-4,Win,3,0,0,0,0,0,1
2016,2016-05-04, Heegan S.C , Sahafi FC ,2,2,0,0,Draw,3,0,1,0,0,1,1
2016,2016-05-05, Waxool FC , Horseed S.C ,2,1,1,-1,Win,0,1,0,1,1,0,0
2016,2016-05-06, Dekedda SC , Jeenyo  FC ,1,0,1,-1,Win,4,3,0,2,2,0,3
2016,2016-05-07, Mogadishu City Club , Gaadiidka FC ,2,1,1,-1,Win,3,1,1,1,1,1,1
2016,2016-05-08, Heegan S.C , Elman FC ,0,0,0,0,Draw,2,2,0,1,1,0,3
2016,2016-05-09, Waxool FC , Badbaado FC ,1,1,0,0,Draw,1,0,0,0,0,0,0
2016,2016-05-10, Horseed S.C , Sahafi FC ,2,1,1,-1,Win,1,0,1,0,0,1,3
2016,2016-05-11, Mogadishu City Club , Dekedda SC ,0,0,0,0,Draw,4,5,1,0,0,1,2
2016,2016-05-12, Heegan S.C , Jeenyo  FC ,1,1,0,0,Draw,1,2,1,0,0,1,3
2016,2016-05-13, Waxool FC , Gaadiidka FC ,3,2,1,-1,Win,1,1,0,1,1,0,0
2016,2016-05-14, Horseed S.C , Elman FC ,2,0,2,-2,Win,2,2,0,2,2,0,2
2016,2016-05-15, Sahafi FC , Badbaado FC ,12,1,11,-11,Win,0,0,2,0,0,2,0
2016,2016-11-18, Heegan S.C , Elman FC ,0,2,-2,2,Loss,1,1,0,1,1,0,4
2016,2016-11-20, Gaadiidka FC , Jeenyo  FC ,2,2,0,0,Draw,1,2,2,2,2,2,1
2016,2016-11-21, Jazeera SC , Mogadishu City Club ,1,3,-2,2,Loss,3,3,0,0,0,0,0
2016,2016-11-22, Bariga Dhexe , Dekedda SC ,1,3,-2,2,Loss,4,4,0,0,0,0,0
2016,2016-11-23, Horseed S.C , Waxool FC ,2,1,1,-1,Win,2,2,1,1,1,1,0
2016,2016-11-24, Jeenyo  FC , Heegan S.C ,1,1,0,0,Draw,1,1,0,1,1,0,4
2016,2016-11-25, Elman FC , Mogadishu City Club ,1,2,-1,1,Loss,1,4,0,1,1,0,5
2016,2016-11-26, Gaadiidka FC , Dekedda SC ,1,1,0,0,Draw,1,4,0,1,1,0,3
2016,2016-11-29, Jazeera SC , Waxool FC ,1,4,-3,3,Loss,3,2,0,0,0,0,1
2016,2016-11-29, Bariga Dhexe , Horseed S.C ,1,1,0,0,Draw,3,3,0,0,0,0,0
2017,2017-02-13, Heegan S.C , Mogadishu City Club ,0,0,0,0,Draw,0,4,1,1,1,1,4
2017,2017-02-13, Jeenyo  FC , Dekedda SC ,2,2,0,0,Draw,0,3,2,1,1,2,3
2017,2017-02-14, Elman FC , Waxool FC ,5,2,3,-3,Win,1,3,1,0,0,1,0
2017,2017-02-14, Gaadiidka FC , Horseed S.C ,1,1,0,0,Draw,0,3,0,1,1,0,2
2017,2017-02-16, Jazeera SC , Bariga Dhexe ,0,2,-2,2,Loss,2,2,0,1,1,0,0
2017,2017-02-16, Dekedda SC , Heegan S.C ,1,1,0,0,Draw,2,0,1,2,2,1,1
2017,2017-02-17, Mogadishu City Club , Waxool FC ,3,0,3,-3,Win,3,2,1,0,0,1,0
2017,2017-02-17, Jeenyo  FC , Horseed S.C ,1,0,1,-1,Win,0,3,2,0,0,2,2
2017,2017-02-20, Gaadiidka FC , Jazeera SC ,7,0,7,-7,Win,0,1,0,0,0,0,0
2017,2017-02-20, Elman FC , Bariga Dhexe ,4,0,4,-4,Win,2,2,0,0,0,0,0
2017,2017-02-21, Heegan S.C , Waxool FC ,2,0,2,-2,Win,0,2,1,0,0,1,0
2017,2017-02-21, Dekedda SC , Horseed S.C ,1,2,-1,1,Loss,1,2,2,1,1,2,2
2017,2017-02-23, Mogadishu City Club , Bariga Dhexe ,5,1,4,-4,Win,3,1,0,0,0,0,0
2017,2017-02-23, Jeenyo  FC , Jazeera SC ,2,2,0,0,Draw,1,0,0,0,0,0,0
2017,2017-02-24, Horseed S.C , Heegan S.C ,2,1,1,-1,Win,2,1,1,3,3,1,3
2017,2017-02-24, Elman FC , Gaadiidka FC ,3,1,2,-2,Win,3,1,1,0,0,1,1
2017,2017-02-27, Dekedda SC , Jazeera SC ,6,0,6,-6,Win,1,0,0,0,0,0,0
2017,2017-02-27, Waxool FC , Bariga Dhexe ,0,1,-1,1,Loss,1,1,1,0,0,1,1
2017,2017-02-28, Mogadishu City Club , Gaadiidka FC ,2,1,1,-1,Win,4,1,2,1,1,2,1
2017,2017-02-28, Jeenyo  FC , Elman FC ,1,1,0,0,Draw,1,4,0,0,0,0,5
2017,2017-03-02, Horseed S.C , Jazeera SC ,2,0,2,-2,Win,2,0,0,0,0,0,0
2017,2017-03-02, Heegan S.C , Bariga Dhexe ,1,2,-1,1,Loss,1,2,0,0,0,0,0
2017,2017-03-03, Dekedda SC , Elman FC ,0,0,0,0,Draw,1,3,2,2,2,2,1
2017,2017-03-03, Waxool FC , Gaadiidka FC ,0,4,-4,4,Loss,1,1,1,1,1,1,0
2017,2017-03-06, Mogadishu City Club , Jeenyo  FC ,2,2,0,0,Draw,4,1,1,1,1,1,3
2017,2017-03-06, Jazeera SC , Heegan S.C ,1,2,-1,1,Loss,0,1,0,0,0,0,0
2017,2017-03-07, Bariga Dhexe , Gaadiidka FC ,0,6,-6,6,Loss,3,2,0,0,0,0,0
2017,2017-03-07, Horseed S.C , Elman FC ,1,1,0,0,Draw,3,3,1,2,2,1,2
2017,2017-03-09, Waxool FC , Jeenyo  FC ,0,5,-5,5,Loss,0,1,0,1,1,0,0
2017,2017-03-09, Dekedda SC , Mogadishu City Club ,1,0,1,-1,Win,1,3,0,1,1,0,3
2017,2017-03-10, Jazeera SC , Elman FC ,0,7,-7,7,Loss,0,2,0,0,0,0,0
2017,2017-03-10, Heegan S.C , Gaadiidka FC ,1,0,1,-1,Win,2,3,2,0,0,2,1
2017,2017-03-13, Bariga Dhexe , Jeenyo  FC ,1,5,-4,4,Loss,2,2,0,0,0,0,0
2017,2017-03-13, Horseed S.C , Mogadishu City Club ,0,3,-3,3,Loss,3,3,0,3,3,0,3
2017,2017-03-14, Waxool FC , Dekedda SC ,1,7,-6,6,Loss,0,2,0,1,1,0,1
2017,2017-03-20, Elman FC , Heegan S.C ,0,0,0,0,Draw,2,3,1,0,0,1,4
2017,2017-03-20, Jeenyo  FC , Gaadiidka FC ,1,1,0,0,Draw,2,2,2,2,2,2,2
2017,2017-03-21, Mogadishu City Club , Jazeera SC ,3,1,2,-2,Win,3,0,0,0,0,0,0
2017,2017-03-21, Dekedda SC , Bariga Dhexe ,3,0,3,-3,Win,3,2,0,0,0,0,0
2017,2017-03-23, Waxool FC , Horseed S.C ,0,0,0,0,Draw,0,3,1,2,2,1,0
2017,2017-03-23, Dekedda SC , Gaadiidka FC ,2,1,1,-1,Win,4,2,1,0,0,1,4
2017,2017-03-23, Heegan S.C , Jeenyo  FC ,4,3,1,-1,Win,2,2,1,0,0,1,5
2017,2017-03-23, Mogadishu City Club , Elman FC ,0,1,-1,1,Loss,3,1,1,0,0,1,5
2017,2017-03-27, Horseed S.C , Bariga Dhexe ,0,0,0,0,Draw,2,2,0,0,0,0,1
2017,2017-03-27, Waxool FC , Jazeera SC ,1,2,-1,1,Loss,0,0,0,0,0,0,1
2017,2017-03-27, Mogadishu City Club , Heegan S.C ,0,1,-1,1,Loss,2,3,1,1,1,1,5
2017,2017-03-27, Dekedda SC , Jeenyo  FC ,4,0,4,-4,Win,4,2,1,2,2,1,4
2017,2017-03-30, Waxool FC , Elman FC ,0,2,-2,2,Loss,0,2,0,2,2,0,0
2017,2017-03-30, Horseed S.C , Gaadiidka FC ,2,1,1,-1,Win,1,2,1,0,0,1,3
2017,2017-03-31, Bariga Dhexe , Jazeera SC ,0,1,-1,1,Loss,1,1,1,0,0,1,0
2017,2017-05-08, Heegan S.C , Dekedda SC ,0,2,-2,2,Loss,4,5,2,1,1,2,2
2017,2017-05-09, Waxool FC , Mogadishu City Club ,2,1,1,-1,Win,0,2,0,2,2,0,0
2017,2017-05-11, Horseed S.C , Jeenyo  FC ,1,0,1,-1,Win,1,2,0,3,3,0,2
2017,2017-05-12, Bariga Dhexe , Elman FC ,0,6,-6,6,Loss,0,3,0,1,1,0,0
2017,2017-05-14, Jazeera SC , Gaadiidka FC ,1,6,-5,5,Loss,2,1,0,1,1,0,0
2017,2017-05-15, Waxool FC , Heegan S.C ,0,2,-2,2,Loss,1,3,0,2,2,0,0
2017,2017-05-16, Horseed S.C , Dekedda SC ,1,1,0,0,Draw,2,5,1,2,2,1,2
2017,2017-05-18, Bariga Dhexe , Mogadishu City Club ,1,4,-3,3,Loss,0,2,0,1,1,0,0
2017,2017-05-19, Jazeera SC , Jeenyo  FC ,1,3,-2,2,Loss,2,1,0,0,0,0,1
2017,2017-05-21, Gaadiidka FC , Elman FC ,3,0,3,-3,Win,1,4,0,2,2,0,1
2017,2017-07-06, Heegan S.C , Horseed S.C ,1,1,0,0,Draw,3,2,3,2,2,3,3
2017,2017-07-07, Bariga Dhexe , Waxool FC ,0,2,-2,2,Loss,0,1,0,1,1,0,1
2017,2017-07-10, Jazeera SC , Dekedda SC ,0,1,-1,1,Loss,2,4,0,1,1,0,0
2017,2017-07-11, Gaadiidka FC , Mogadishu City Club ,0,0,0,0,Draw,2,2,1,3,3,1,1
2017,2017-07-12, Elman FC , Jeenyo  FC ,0,1,-1,1,Loss,3,1,0,0,0,0,6
2017,2017-07-13, Bariga Dhexe , Heegan S.C ,0,4,-4,4,Loss,0,3,0,0,0,0,0
2017,2017-07-14, Jazeera SC , Horseed S.C ,1,3,-2,2,Loss,2,2,0,1,1,0,0
2017,2017-07-17, Gaadiidka FC , Waxool FC ,1,1,0,0,Draw,2,2,1,1,1,1,0
2017,2017-07-18, Elman FC , Dekedda SC ,0,2,-2,2,Loss,3,4,2,2,2,2,2
2017,2017-07-19, Jeenyo  FC , Mogadishu City Club ,0,3,-3,3,Loss,2,1,1,1,1,1,4
2017,2017-07-20, Heegan S.C , Jazeera SC ,2,0,2,-2,Win,3,1,0,0,0,0,0
2017,2017-07-21, Gaadiidka FC , Bariga Dhexe ,2,0,2,-2,Win,2,0,0,0,0,0,0
2017,2017-07-24, Elman FC , Horseed S.C ,1,1,0,0,Draw,2,3,2,1,1,2,3
2017,2017-07-25, Jeenyo  FC , Waxool FC ,0,0,0,0,Draw,2,2,1,0,0,1,0
2017,2017-07-26, Mogadishu City Club , Dekedda SC ,1,1,0,0,Draw,2,4,1,1,1,1,3
2017,2017-07-27, Gaadiidka FC , Heegan S.C ,2,3,-1,1,Loss,3,3,0,3,3,0,1
2017,2017-07-28, Elman FC , Jazeera SC ,4,0,4,-4,Win,1,0,0,0,0,0,0
2017,2017-07-31, Jeenyo  FC , Bariga Dhexe ,1,0,1,-1,Win,2,0,0,0,0,0,0
2017,2017-08-01, Mogadishu City Club , Horseed S.C ,1,0,1,-1,Win,2,2,3,0,0,3,3
2017,2017-08-02, Dekedda SC , Waxool FC ,2,0,2,-2,Win,3,2,1,0,0,1,1
2018,2018-01-22, Dekedda SC , Waxool FC ,1,0,1,-1,Win,3,1,2,0,0,2,1
2018,2018-01-23, Batroolka FC , Gaadiidka FC ,0,0,0,0,Draw,1,2,0,2,2,0,1
2018,2018-01-24, Heegan S.C , Elman FC ,4,1,3,-3,Win,4,1,0,1,1,0,5
2018,2018-01-25, Madbacadda FC , Jeenyo  FC ,1,1,0,0,Draw,1,3,0,0,0,0,0
2018,2018-01-26, Horseed S.C , Mogadishu City Club ,1,0,1,-1,Win,1,3,0,4,4,0,3
2018,2018-01-29, Gaadiidka FC , Dekedda SC ,1,1,0,0,Draw,1,4,0,2,2,0,4
2018,2018-01-30, Waxool FC , Elman FC ,0,4,-4,4,Loss,1,1,0,2,2,0,0
2018,2018-01-31, Batroolka FC , Jeenyo  FC ,0,0,0,0,Draw,1,2,0,2,2,0,1
2018,2018-02-01, Heegan S.C , Mogadishu City Club ,1,1,0,0,Draw,4,2,1,1,1,1,5
2018,2018-02-02, Madbacadda FC , Horseed S.C ,0,0,0,0,Draw,1,2,0,0,0,0,0
2018,2018-02-05, Dekedda SC , Elman FC ,1,0,1,-1,Win,3,2,2,2,2,2,2
2018,2018-02-06, Gaadiidka FC , Jeenyo  FC ,0,1,-1,1,Loss,1,1,2,2,2,2,3
2018,2018-02-07, Waxool FC , Mogadishu City Club ,1,4,-3,3,Loss,0,2,1,2,2,1,0
2018,2018-02-08, Batroolka FC , Horseed S.C ,1,5,-4,4,Loss,1,2,0,2,2,0,1
2018,2018-02-09, Heegan S.C , Madbacadda FC ,0,0,0,0,Draw,4,1,0,0,0,0,0
2018,2018-02-12, Jeenyo  FC , Dekedda SC ,0,2,-2,2,Loss,2,3,2,2,2,2,4
2018,2018-02-13, Elman FC , Mogadishu City Club ,2,6,-4,4,Loss,2,2,0,1,1,0,5
2018,2018-02-14, Gaadiidka FC , Horseed S.C ,1,3,-2,2,Loss,1,2,0,2,2,0,3
2018,2018-02-15, Waxool FC , Madbacadda FC ,0,1,-1,1,Loss,0,1,0,0,0,0,0
2018,2018-02-16, Batroolka FC , Heegan S.C ,1,2,-1,1,Loss,0,3,0,2,2,0,0
2018,2018-02-19, Dekedda SC , Mogadishu City Club ,1,0,1,-1,Win,4,3,1,1,1,1,4
2018,2018-02-20, Jeenyo  FC , Horseed S.C ,0,2,-2,2,Loss,2,3,3,1,1,3,2
2018,2018-02-21, Elman FC , Madbacadda FC ,5,1,4,-4,Win,2,2,0,0,0,0,0
2018,2018-02-22, Gaadiidka FC , Heegan S.C ,1,2,-1,1,Loss,0,3,0,3,3,0,1
2018,2018-02-23, Waxool FC , Batroolka FC ,2,2,0,0,Draw,0,0,0,0,0,0,0
2018,2018-02-26, Horseed S.C , Dekedda SC ,0,0,0,0,Draw,4,4,1,2,2,1,3
2018,2018-02-27, Mogadishu City Club , Madbacadda FC ,2,0,2,-2,Win,2,1,0,0,0,0,0
2018,2018-02-28, Jeenyo  FC , Heegan S.C ,1,0,1,-1,Win,1,3,0,2,2,0,5
2018,2018-03-01, Elman FC , Batroolka FC ,1,4,-3,3,Loss,2,0,2,0,0,2,0
2018,2018-03-02, Gaadiidka FC , Waxool FC ,1,1,0,0,Draw,0,0,1,1,1,1,1
2018,2018-03-05, Dekedda SC , Madbacadda FC ,7,1,6,-6,Win,3,1,0,0,0,0,0
2018,2018-03-06, Horseed S.C , Heegan S.C ,0,0,0,0,Draw,3,2,2,3,3,2,4
2018,2018-03-07, Mogadishu City Club , Batroolka FC ,1,1,0,0,Draw,3,1,2,0,0,2,0
2018,2018-03-08, Jeenyo  FC , Waxool FC ,0,1,-1,1,Loss,2,0,1,0,0,1,1
2018,2018-03-09, Elman FC , Gaadiidka FC ,3,0,3,-3,Win,2,0,2,1,1,2,1
2018,2018-03-09, Elman FC , Gaadiidka FC ,3,0,3,-3,Win,2,0,2,1,1,2,1
2018,2018-03-12, Heegan S.C , Dekedda SC ,0,0,0,0,Draw,2,4,2,1,1,2,2
2018,2018-03-13, Madbacadda FC , Batroolka FC ,0,0,0,0,Draw,1,1,0,0,0,0,0
2018,2018-03-14, Horseed S.C , Waxool FC ,3,0,3,-3,Win,3,1,2,1,1,2,1
2018,2018-03-15, Mogadishu City Club , Gaadiidka FC ,3,0,3,-3,Win,3,0,3,1,1,3,2
2018,2018-03-16, Jeenyo  FC , Elman FC ,2,2,0,0,Draw,2,3,0,0,0,0,6
2018,2018-03-19, Dekedda SC , Batroolka FC ,5,0,5,-5,Win,3,1,1,0,0,1,0
2018,2018-03-20, Heegan S.C , Waxool FC ,5,0,5,-5,Win,2,1,2,0,0,2,0
2018,2018-03-21, Madbacadda FC , Gaadiidka FC ,0,2,-2,2,Loss,1,0,0,0,0,0,0
2018,2018-03-22, Horseed S.C , Elman FC ,2,0,2,-2,Win,3,3,1,2,2,1,4
2018,2018-03-23, Mogadishu City Club , Jeenyo  FC ,4,2,2,-2,Win,3,1,1,1,1,1,4
2018,2018-03-26, Waxool FC , Dekedda SC ,1,4,-3,3,Loss,1,3,0,3,3,0,1
2018,2018-03-27, Gaadiidka FC , Batroolka FC ,0,1,-1,1,Loss,1,1,2,0,0,2,2
2018,2018-03-28, Elman FC , Heegan S.C ,1,2,-1,1,Loss,2,2,1,1,1,1,5
2018,2018-03-29, Jeenyo  FC , Madbacadda FC ,1,1,0,0,Draw,1,0,0,0,0,0,1
2018,2018-03-30, Mogadishu City Club , Horseed S.C ,3,2,1,-1,Win,3,3,4,1,1,4,3
2018,2018-03-31, Dekedda SC , Gaadiidka FC ,6,0,6,-6,Win,3,1,2,0,0,2,5
2018,2018-04-01, Elman FC , Waxool FC ,4,1,3,-3,Win,2,1,2,0,0,2,0
2018,2018-04-02, Jeenyo  FC , Batroolka FC ,6,0,6,-6,Win,1,2,2,0,0,2,2
2018,2018-04-03, Mogadishu City Club , Heegan S.C ,1,1,0,0,Draw,4,2,1,1,1,1,6
2018,2018-04-04, Horseed S.C , Madbacadda FC ,1,1,0,0,Draw,2,0,0,0,0,0,1
2018,2018-04-05, Elman FC , Dekedda SC ,3,0,3,-3,Win,2,4,2,3,3,2,2
2018,2018-04-07, Jeenyo  FC , Gaadiidka FC ,3,6,-3,3,Loss,1,1,2,2,2,2,3
2018,2018-04-08, Mogadishu City Club , Waxool FC ,2,0,2,-2,Win,3,1,2,1,1,2,0
2018,2018-04-09, Horseed S.C , Batroolka FC ,5,0,5,-5,Win,2,1,2,0,0,2,1
2018,2018-04-10, Madbacadda FC , Heegan S.C ,1,0,1,-1,Win,0,2,0,0,0,0,1
2018,2018-04-11, Dekedda SC , Jeenyo  FC ,3,0,3,-3,Win,3,1,2,2,2,2,4
2018,2018-04-12, Mogadishu City Club , Elman FC ,4,2,2,-2,Win,4,2,1,0,0,1,5
2018,2018-04-13, Horseed S.C , Gaadiidka FC ,0,0,0,0,Draw,3,2,2,0,0,2,3
2018,2018-04-14, Madbacadda FC , Waxool FC ,1,2,-1,1,Loss,1,0,0,0,0,0,0
2018,2018-04-15, Heegan S.C , Batroolka FC ,3,0,3,-3,Win,2,1,2,0,0,2,0
2018,2018-04-16, Mogadishu City Club , Dekedda SC ,0,0,0,0,Draw,4,4,1,2,2,1,4
2018,2018-04-17, Horseed S.C , Jeenyo  FC ,0,0,0,0,Draw,2,1,1,3,3,1,2
2018,2018-04-18, Madbacadda FC , Elman FC ,1,1,0,0,Draw,1,2,0,1,1,0,0
2018,2018-04-19, Heegan S.C , Gaadiidka FC ,3,1,2,-2,Win,3,2,3,0,0,3,1
2018,2018-04-20, Batroolka FC , Waxool FC ,1,2,-1,1,Loss,1,1,0,0,0,0,1
2018,2018-04-21, Dekedda SC , Horseed S.C ,2,2,0,0,Draw,3,1,2,1,1,2,4
2018,2018-04-22, Madbacadda FC , Mogadishu City Club ,2,2,0,0,Draw,1,3,0,1,1,0,0
2018,2018-04-23, Heegan S.C , Jeenyo  FC ,4,1,3,-3,Win,3,1,2,1,1,2,5
2018,2018-04-24, Batroolka FC , Mogadishu City Club ,1,2,-1,1,Loss,1,2,0,2,2,0,1
2018,2018-04-25, Waxool FC , Jeenyo  FC ,1,2,-1,1,Loss,2,1,0,1,1,0,1
2018,2018-04-26, Gaadiidka FC , Mogadishu City Club ,1,2,-1,1,Loss,1,3,1,4,4,1,2
2018,2018-04-27, Batroolka FC , Elman FC ,2,2,0,0,Draw,0,2,0,2,2,0,0
2018,2018-04-28, Jeenyo  FC , Mogadishu City Club ,1,2,-1,1,Loss,1,3,1,2,2,1,4
2018,2018-04-29, Heegan S.C , Horseed S.C ,1,0,1,-1,Win,3,1,3,2,2,3,5
2018,2018-04-30, Gaadiidka FC , Elman FC ,2,2,0,0,Draw,1,2,1,4,4,1,1
2018,2018-05-01, Batroolka FC , Madbacadda FC ,1,4,-3,3,Loss,0,1,0,0,0,0,1
2018,2018-05-02, Dekedda SC , Heegan S.C ,1,1,0,0,Draw,2,4,1,2,2,1,3
2018,2018-05-03, Waxool FC , Gaadiidka FC ,1,3,-2,2,Loss,2,1,1,1,1,1,2
2018,2018-05-04, Elman FC , Jeenyo  FC ,2,1,1,-1,Win,1,1,0,0,0,0,7
2018,2018-05-05, Madbacadda FC , Dekedda SC ,0,5,-5,5,Loss,2,1,0,1,1,0,0
2018,2018-05-06, Waxool FC , Horseed S.C ,1,4,-3,3,Loss,2,1,1,3,3,1,1
2018,2018-05-08, Gaadiidka FC , Madbacadda FC ,4,1,3,-3,Win,1,1,0,0,0,0,0
2018,2018-05-09, Batroolka FC , Dekedda SC ,1,6,-5,5,Loss,0,2,0,2,2,0,0
2018,2018-05-10, Elman FC , Horseed S.C ,2,3,-1,1,Loss,1,1,2,2,2,2,4
2018,2018-05-11, Waxool FC , Heegan S.C ,0,7,-7,7,Loss,2,4,0,3,3,0,0
2019,2019-02-07, Dekedda SC , Gaadiidka FC ,1,1,0,0,Draw,2,2,3,0,0,3,5
2019,2019-02-08, Jeenyo  FC , Mogadishu City Club ,1,0,1,-1,Win,1,3,1,2,2,1,4
2019,2019-02-11, Heegan S.C , Madbacadda FC ,1,0,1,-1,Win,4,1,0,1,1,0,1
2019,2019-02-12, Jazeera SC , Midnimo FC ,0,1,-1,1,Loss,0,4,1,0,0,1,2
2019,2019-02-13, Horseed S.C , Elman FC ,0,0,0,0,Draw,2,1,2,2,2,2,4
2019,2019-02-14, Jeenyo  FC , Dekedda SC ,2,8,-6,6,Loss,2,2,2,3,3,2,4
2019,2019-02-15, Gaadiidka FC , Madbacadda FC ,0,0,0,0,Draw,2,1,1,0,0,1,0
2019,2019-02-18, Mogadishu City Club , Midnimo FC ,1,1,0,0,Draw,3,5,0,0,0,0,0
2019,2019-02-19, Heegan S.C , Elman FC ,1,3,-2,2,Loss,4,1,1,1,1,1,5
2019,2019-02-20, Jazeera SC , Horseed S.C ,1,1,0,0,Draw,0,2,0,1,1,0,0
2019,2019-02-21, Dekedda SC , Madbacadda FC ,1,0,1,-1,Win,3,1,1,0,0,1,0
2019,2019-02-22, Jeenyo  FC , Midnimo FC ,0,1,-1,1,Loss,2,4,0,0,0,0,0
2019,2019-02-25, Gaadiidka FC , Elman FC ,1,3,-2,2,Loss,2,2,1,4,4,1,2
2019,2019-02-26, Mogadishu City Club , Horseed S.C ,1,2,-1,1,Loss,3,2,5,1,1,5,3
2019,2019-02-27, Heegan S.C , Jazeera SC ,3,0,3,-3,Win,3,0,1,0,0,1,0
2019,2019-02-28, Midnimo FC , Dekedda SC ,0,2,-2,2,Loss,4,4,0,0,0,0,0
2019,2019-03-01, Madbacadda FC , Elman FC ,1,0,1,-1,Win,0,3,0,1,1,0,1
2019,2019-03-03, Jeenyo  FC , Horseed S.C ,0,4,-4,4,Loss,1,3,3,1,1,3,3
2019,2019-03-05, Gaadiidka FC , Jazeera SC ,0,1,-1,1,Loss,2,0,1,0,0,1,0
2019,2019-03-06, Mogadishu City Club , Heegan S.C ,1,0,1,-1,Win,2,3,1,1,1,1,7
2019,2019-03-07, Dekedda SC , Elman FC ,1,0,1,-1,Win,4,2,3,3,3,3,2
2019,2019-03-08, Midnimo FC , Horseed S.C ,0,2,-2,2,Loss,3,3,0,0,0,0,0
2019,2019-03-11, Madbacadda FC , Jazeera SC ,1,2,-1,1,Loss,1,1,0,0,0,0,0
2019,2019-03-12, Jeenyo  FC , Heegan S.C ,0,2,-2,2,Loss,1,3,1,3,3,1,5
2019,2019-03-13, Gaadiidka FC , Mogadishu City Club ,1,2,-1,1,Loss,1,2,1,4,4,1,2
2019,2019-03-14, Horseed S.C , Dekedda SC ,1,0,1,-1,Win,3,4,1,2,2,1,5
2019,2019-03-15, Elman FC , Jazeera SC ,3,2,1,-1,Win,2,2,1,0,0,1,0
2019,2019-03-18, Midnimo FC , Heegan S.C ,1,3,-2,2,Loss,2,3,0,0,0,0,0
2019,2019-03-19, Madbacadda FC , Mogadishu City Club ,1,4,-3,3,Loss,1,2,0,1,1,0,1
2019,2019-03-20, Jeenyo  FC , Gaadiidka FC ,2,4,-2,2,Loss,1,0,2,2,2,2,3
2019,2019-03-21, Dekedda SC , Jazeera SC ,2,1,1,-1,Win,4,2,1,0,0,1,0
2019,2019-03-22, Horseed S.C , Heegan S.C ,0,1,-1,1,Loss,4,3,2,4,4,2,5
2019,2019-03-25, Elman FC , Mogadishu City Club ,1,1,0,0,Draw,3,3,0,2,2,0,5
2019,2019-03-26, Midnimo FC , Gaadiidka FC ,0,2,-2,2,Loss,1,1,0,0,0,0,0
2019,2019-03-27, Madbacadda FC , Jeenyo  FC ,2,1,1,-1,Win,1,0,0,0,0,0,2
2019,2019-03-28, Heegan S.C , Dekedda SC ,1,1,0,0,Draw,4,4,2,1,1,2,4
2019,2019-03-29, Jazeera SC , Mogadishu City Club ,2,5,-3,3,Loss,2,3,0,1,1,0,0
2019,2019-04-01, Horseed S.C , Gaadiidka FC ,6,0,6,-6,Win,4,2,2,0,0,2,4
2019,2019-04-02, Elman FC , Jeenyo  FC ,3,1,2,-2,Win,2,0,1,0,0,1,7
2019,2019-04-03, Midnimo FC , Madbacadda FC ,1,0,1,-1,Win,1,2,0,0,0,0,0
2019,2019-04-04, Dekedda SC , Mogadishu City Club ,1,0,1,-1,Win,3,4,2,1,1,2,5
2019,2019-04-04, Heegan S.C , Gaadiidka FC ,4,0,4,-4,Win,3,2,4,0,0,4,1
2019,2019-04-08, Jeenyo  FC , Jazeera SC ,0,1,-1,1,Loss,0,2,0,0,0,0,1
2019,2019-04-09, Horseed S.C , Madbacadda FC ,4,0,4,-4,Win,4,2,0,0,0,0,2
2019,2019-04-10, Elman FC , Midnimo FC ,1,2,-1,1,Loss,2,1,0,0,0,0,0
2019,2019-04-22, Gaadiidka FC , Dekedda SC ,0,4,-4,4,Loss,2,3,0,3,3,0,6
2019,2019-04-23, Jeenyo  FC , Mogadishu City Club ,0,4,-4,4,Loss,0,3,2,2,2,2,4
2019,2019-04-24, Madbacadda FC , Heegan S.C ,3,4,-1,1,Loss,1,4,1,1,1,1,1
2019,2019-04-25, Midnimo FC , Jazeera SC ,2,2,0,0,Draw,2,2,0,1,1,0,2
2019,2019-04-26, Elman FC , Horseed S.C ,2,1,1,-1,Win,2,4,2,2,2,2,5
2019,2019-04-29, Dekedda SC , Jeenyo  FC ,4,1,3,-3,Win,3,0,3,2,2,3,4
2019,2019-04-30, Madbacadda FC , Gaadiidka FC ,0,2,-2,2,Loss,1,2,0,1,1,0,1
2019,2019-05-02, Elman FC , Heegan S.C ,2,1,1,-1,Win,3,4,1,1,1,1,5
2019,2019-05-03, Horseed S.C , Jazeera SC ,3,1,2,-2,Win,3,1,1,0,0,1,1
2019,2019-06-07, Madbacadda FC , Dekedda SC ,0,2,-2,2,Loss,1,4,0,2,2,0,0
2019,2019-06-08, Midnimo FC , Jeenyo  FC ,0,0,0,0,Draw,2,0,0,0,0,0,0
2019,2019-06-09, Elman FC , Gaadiidka FC ,3,1,2,-2,Win,3,2,4,1,1,4,2
2019,2019-06-10, Horseed S.C , Mogadishu City Club ,1,0,1,-1,Win,3,3,1,5,5,1,3
2019,2019-06-11, Jazeera SC , Heegan S.C ,0,0,0,0,Draw,1,3,0,2,2,0,0
2019,2019-06-12, Elman FC , Madbacadda FC ,1,1,0,0,Draw,4,0,1,1,1,1,1
2019,2019-06-12, Dekedda SC , Midnimo FC ,1,0,1,-1,Win,4,2,0,0,0,0,0
2019,2019-06-13, Horseed S.C , Jeenyo  FC ,3,0,3,-3,Win,4,0,1,3,3,1,3
2019,2019-06-13, Jazeera SC , Gaadiidka FC ,2,2,0,0,Draw,1,1,0,1,1,0,0
2019,2019-06-14, Heegan S.C , Mogadishu City Club ,0,0,0,0,Draw,2,2,1,2,2,1,7
2019,2019-06-15, Elman FC , Dekedda SC ,2,0,2,-2,Win,3,5,3,4,4,3,2
2019,2019-06-15, Horseed S.C , Midnimo FC ,3,0,3,-3,Win,4,2,0,0,0,0,0
2019,2019-06-17, Jazeera SC , Madbacadda FC ,0,0,0,0,Draw,1,0,0,0,0,0,0
2019,2019-06-18, Heegan S.C , Jeenyo  FC ,1,1,0,0,Draw,2,0,3,1,1,3,5
2019,2019-06-19, Mogadishu City Club , Gaadiidka FC ,1,0,1,-1,Win,2,1,4,1,1,4,2
2019,2019-06-20, Dekedda SC , Horseed S.C ,1,1,0,0,Draw,4,4,2,2,2,2,5
2019,2019-06-20, Jazeera SC , Elman FC ,2,2,0,0,Draw,0,4,0,2,2,0,0
2019,2019-06-21, Heegan S.C , Midnimo FC ,2,0,2,-2,Win,1,1,0,0,0,0,0
2019,2019-06-21, Mogadishu City Club , Madbacadda FC ,0,0,0,0,Draw,2,0,1,0,0,1,1
2019,2019-06-22, Gaadiidka FC , Jeenyo  FC ,2,1,1,-1,Win,1,0,2,2,2,2,3
2019,2019-06-24, Jazeera SC , Dekedda SC ,1,4,-3,3,Loss,0,3,0,2,2,0,0
2019,2019-06-25, Heegan S.C , Horseed S.C ,1,1,0,0,Draw,1,4,4,2,2,4,5
2019,2019-06-26, Mogadishu City Club , Elman FC ,2,2,0,0,Draw,2,3,2,0,0,2,6
2019,2019-06-27, Gaadiidka FC , Midnimo FC ,1,0,1,-1,Win,2,0,0,0,0,0,0
2019,2019-06-28, Jeenyo  FC , Madbacadda FC ,2,4,-2,2,Loss,0,0,0,1,1,0,2
2019,2019-06-29, Dekedda SC , Heegan S.C ,1,0,1,-1,Win,3,1,1,2,2,1,5
2019,2019-06-30, Mogadishu City Club , Jazeera SC ,4,5,-1,1,Loss,1,0,1,0,0,1,0
2019,2019-07-01, Gaadiidka FC , Horseed S.C ,0,3,-3,3,Loss,2,3,0,3,3,0,4
2019,2019-07-01, Jeenyo  FC , Elman FC ,2,6,-4,4,Loss,0,2,0,2,2,0,7
2019,2019-07-02, Madbacadda FC , Midnimo FC ,0,1,-1,1,Loss,1,0,0,1,1,0,0
2019,2019-07-02, Mogadishu City Club , Dekedda SC ,2,3,-1,1,Loss,1,3,1,3,3,1,5
2019,2019-07-03, Gaadiidka FC , Heegan S.C ,0,1,-1,1,Loss,2,1,0,5,5,0,1
2019,2019-07-03, Jeenyo  FC , Jazeera SC ,2,4,-2,2,Loss,0,1,0,0,0,0,1
2019,2019-07-04, Madbacadda FC , Horseed S.C ,0,3,-3,3,Loss,1,3,0,1,1,0,2
2019,2019-07-04, Midnimo FC , Elman FC ,0,0,0,0,Draw,1,2,0,0,0,0,0
2019,2019-12-26, Dekedda SC , Midnimo FC ,1,1,0,0,Draw,3,1,1,0,0,1,0
2019,2019-12-26, Raadsan FC , Gaadiidka FC ,3,0,3,-3,Win,4,2,0,0,0,0,0
2019,2019-12-28, Mogadishu City Club , Rajo FC ,1,2,-1,1,Loss,1,0,0,0,0,0,0
2019,2019-12-28, Elman FC , Heegan S.C ,1,1,0,0,Draw,2,2,2,1,1,2,5
2019,2019-12-30, Horseed S.C , Jazeera SC ,1,1,0,0,Draw,3,2,2,0,0,2,1
2020,2020-01-01, Gaadiidka FC , Dekedda SC ,0,1,-1,1,Loss,2,3,0,3,3,0,6
2020,2020-01-02, Midnimo FC , Heegan S.C ,0,2,-2,2,Loss,1,2,0,1,1,0,0
2020,2020-01-03, Raadsan FC , Rajo FC ,2,2,0,0,Draw,4,1,0,0,0,0,0
2020,2020-01-06, Elman FC , Jazeera SC ,4,1,3,-3,Win,1,2,2,0,0,2,1
2020,2020-01-07, Mogadishu City Club , Horseed S.C ,0,0,0,0,Draw,0,2,5,2,2,5,3
2020,2020-01-08, Dekedda SC , Heegan S.C ,2,1,1,-1,Win,4,2,2,2,2,2,5
2020,2020-01-09, Gaadiidka FC , Rajo FC ,3,1,2,-2,Win,1,1,0,0,0,0,0
2020,2020-01-10, Midnimo FC , Jazeera SC ,3,0,3,-3,Win,1,2,0,1,1,0,3
2020,2020-01-13, Raadsan FC , Horseed S.C ,2,4,-2,2,Loss,3,2,0,0,0,0,0
2020,2020-01-14, Elman FC , Mogadishu City Club ,1,1,0,0,Draw,2,0,0,2,2,0,7
2020,2020-01-15, Rajo FC , Dekedda SC ,0,2,-2,2,Loss,1,4,0,0,0,0,0
2020,2020-01-16, Heegan S.C , Jazeera SC ,2,0,2,-2,Win,2,2,2,0,0,2,1
2020,2020-01-17, Gaadiidka FC , Horseed S.C ,0,1,-1,1,Loss,1,3,0,3,3,0,4
2020,2020-01-20, Midnimo FC , Mogadishu City Club ,0,4,-4,4,Loss,2,0,0,0,0,0,1
2020,2020-01-21, Raadsan FC , Elman FC ,2,3,-1,1,Loss,3,2,0,0,0,0,0
2020,2020-01-22, Dekedda SC , Jazeera SC ,2,1,1,-1,Win,4,1,2,0,0,2,0
2020,2020-01-23, Rajo FC , Horseed S.C ,0,2,-2,2,Loss,1,3,0,0,0,0,0
2020,2020-01-24, Heegan S.C , Mogadishu City Club ,0,3,-3,3,Loss,3,1,1,2,2,1,8
2020,2020-01-27, Gaadiidka FC , Elman FC ,1,3,-2,2,Loss,1,2,1,5,5,1,2
2020,2020-01-28, Midnimo FC , Raadsan FC ,0,3,-3,3,Loss,1,2,1,0,0,1,1
2020,2020-01-29, Horseed S.C , Dekedda SC ,0,0,0,0,Draw,3,4,2,2,2,2,6
2020,2020-01-30, Jazeera SC , Mogadishu City Club ,1,3,-2,2,Loss,0,2,0,1,1,0,0
2020,2020-01-31, Rajo FC , Elman FC ,1,6,-5,5,Loss,1,3,0,0,0,0,0
2020,2020-02-03, Heegan S.C , Raadsan FC ,2,1,1,-1,Win,2,2,0,0,0,0,0
2020,2020-02-04, Gaadiidka FC , Midnimo FC ,0,2,-2,2,Loss,1,1,1,0,0,1,0
2020,2020-02-05, Dekedda SC , Mogadishu City Club ,0,5,-5,5,Loss,4,3,3,1,1,3,5
2020,2020-02-06, Horseed S.C , Elman FC ,2,3,-1,1,Loss,3,4,2,3,3,2,5
2020,2020-02-07, Jazeera SC , Raadsan FC ,2,2,0,0,Draw,0,1,0,1,1,0,0
2020,2020-02-10, Rajo FC , Midnimo FC ,1,1,0,0,Draw,0,2,0,0,0,0,0
2020,2020-02-11, Heegan S.C , Gaadiidka FC ,1,1,0,0,Draw,3,1,5,0,0,5,1
2020,2020-02-12, Elman FC , Dekedda SC ,0,1,-1,1,Loss,4,3,4,4,4,4,2
2020,2020-02-13, Mogadishu City Club , Raadsan FC ,2,3,-1,1,Loss,4,1,0,0,0,0,0
2020,2020-02-14, Horseed S.C , Midnimo FC ,1,0,1,-1,Win,3,2,1,0,0,1,0
2020,2020-02-17, Jazeera SC , Gaadiidka FC ,1,1,0,0,Draw,0,1,0,1,1,0,1
2020,2020-02-18, Rajo FC , Heegan S.C ,1,2,-1,1,Loss,0,2,0,0,0,0,0
2020,2020-02-19, Dekedda SC , Raadsan FC ,1,0,1,-1,Win,3,2,0,0,0,0,0
2020,2020-02-20, Elman FC , Midnimo FC ,1,1,0,0,Draw,4,1,0,0,0,0,1
2020,2020-02-21, Mogadishu City Club , Gaadiidka FC ,3,0,3,-3,Win,4,0,5,1,1,5,2
2020,2020-02-24, Horseed S.C , Heegan S.C ,1,0,1,-1,Win,3,3,2,4,4,2,6
2020,2020-02-25, Jazeera SC , Rajo FC ,4,2,2,-2,Win,0,0,0,0,0,0,0
2020,2020-03-02, Midnimo FC , Dekedda SC ,0,0,0,0,Draw,1,3,0,1,1,0,1
2020,2020-03-03, Gaadiidka FC , Raadsan FC ,5,0,5,-5,Win,0,2,0,1,1,0,0
2020,2020-03-04, Heegan S.C , Elman FC ,3,1,2,-2,Win,2,3,1,2,2,1,6
2020,2020-03-05, Rajo FC , Mogadishu City Club ,0,5,-5,5,Loss,0,4,0,0,0,0,0
2020,2020-03-06, Jazeera SC , Horseed S.C ,0,1,-1,1,Loss,1,3,0,2,2,0,2
2020,2020-03-09, Dekedda SC , Gaadiidka FC ,1,3,-2,2,Loss,2,1,3,0,0,3,6
2020,2020-03-10, Heegan S.C , Midnimo FC ,0,1,-1,1,Loss,3,1,1,0,0,1,0
2020,2020-03-11, Rajo FC , Raadsan FC ,0,4,-4,4,Loss,0,1,0,0,0,0,1
2020,2020-03-12, Jazeera SC , Elman FC ,2,4,-2,2,Loss,1,2,0,3,3,0,1
2020,2020-03-13, Horseed S.C , Mogadishu City Club ,0,0,0,0,Draw,3,4,2,5,5,2,4
2020,2020-03-16, Heegan S.C , Dekedda SC ,1,0,1,-1,Win,2,2,2,3,3,2,5
2020,2020-03-17, Rajo FC , Gaadiidka FC ,0,7,-7,7,Loss,0,2,0,1,1,0,0
2020,2020-03-18, Jazeera SC , Midnimo FC ,1,2,-1,1,Loss,1,1,1,1,1,1,3
2020,2020-06-18, Horseed S.C , Raadsan FC ,4,0,4,-4,Win,3,2,0,0,0,0,0
2020,2020-06-19, Mogadishu City Club , Elman FC ,2,0,2,-2,Win,3,2,2,0,0,2,8
2020,2020-06-22, Dekedda SC , Rajo FC ,4,1,3,-3,Win,2,0,0,0,0,0,0
2020,2020-06-23, Jazeera SC , Heegan S.C ,0,3,-3,3,Loss,1,3,0,3,3,0,1
2020,2020-06-24, Horseed S.C , Gaadiidka FC ,0,1,-1,1,Loss,4,3,3,0,0,3,4
2020,2020-06-25, Mogadishu City Club , Midnimo FC ,2,1,1,-1,Win,3,2,0,0,0,0,1
2020,2020-06-26, Elman FC , Raadsan FC ,2,1,1,-1,Win,1,2,0,0,0,0,0
2021,2021-01-18, Heegan S.C , Midnimo FC ,1,0,1,-1,Win,3,2,1,0,0,1,0
2021,2021-01-19, Geeska Afrika FC , Jeenyo  FC ,0,0,0,0,Draw,2,0,0,0,0,0,0
2021,2021-01-20, Raadsan FC , Horseed S.C ,1,0,1,-1,Win,1,3,0,1,1,0,0
2021,2021-01-21, Elman FC , Mogadishu City Club ,0,1,-1,1,Loss,2,4,0,3,3,0,8
2021,2021-01-22, Dekedda SC , Gaadiidka FC ,1,1,0,0,Draw,2,4,3,0,0,3,6
2021,2021-01-25, Jeenyo  FC , Heegan S.C ,1,2,-1,1,Loss,0,4,1,3,3,1,6
2021,2021-01-26, Midnimo FC , Horseed S.C ,0,2,-2,2,Loss,2,2,0,2,2,0,0
2021,2021-01-27, Geeska Afrika FC , Mogadishu City Club ,0,2,-2,2,Loss,2,4,0,0,0,0,0
2021,2021-01-28, Raadsan FC , Gaadiidka FC ,1,0,1,-1,Win,2,4,1,1,1,1,0
2021,2021-01-29, Elman FC , Dekedda SC ,2,1,1,-1,Win,2,1,4,4,4,4,2
2021,2021-02-01, Heegan S.C , Horseed S.C ,1,1,0,0,Draw,4,2,4,3,3,4,6
2021,2021-02-02, Jeenyo  FC , Mogadishu City Club ,1,0,1,-1,Win,0,4,2,2,2,2,4
2021,2021-02-03, Midnimo FC , Gaadiidka FC ,1,1,0,0,Draw,2,3,0,1,1,0,0
2021,2021-02-04, Geeska Afrika FC , Dekedda SC ,0,3,-3,3,Loss,1,1,0,0,0,0,0
2021,2021-02-05, Raadsan FC , Elman FC ,1,0,1,-1,Win,3,3,0,1,1,0,0
2021,2021-02-08, Mogadishu City Club , Heegan S.C ,3,2,1,-1,Win,4,4,2,1,1,2,8
2021,2021-02-09, Horseed S.C , Gaadiidka FC ,1,3,-2,2,Loss,2,2,3,0,0,3,4
2021,2021-02-10, Jeenyo  FC , Dekedda SC ,0,4,-4,4,Loss,1,2,2,4,4,2,4
2021,2021-02-11, Midnimo FC , Elman FC ,1,0,1,-1,Win,1,2,0,0,0,0,2
2021,2021-02-12, Geeska Afrika FC , Raadsan FC ,0,2,-2,2,Loss,1,3,1,1,1,1,1
2021,2021-02-15, Heegan S.C , Gaadiidka FC ,3,0,3,-3,Win,3,2,5,0,0,5,2
2021,2021-02-16, Mogadishu City Club , Dekedda SC ,1,0,1,-1,Win,4,3,1,3,3,1,5
2021,2021-02-17, Horseed S.C , Elman FC ,3,0,3,-3,Win,1,2,2,3,3,2,5
2021,2021-02-18, Jeenyo  FC , Raadsan FC ,1,1,0,0,Draw,1,4,0,0,0,0,0
2021,2021-02-22, Midnimo FC , Geeska Afrika FC ,2,1,1,-1,Win,1,0,2,2,2,2,0
2021,2021-02-22, Dekedda SC , Heegan S.C ,0,0,0,0,Draw,2,3,3,3,3,3,5
2021,2021-02-23, Gaadiidka FC , Elman FC ,0,1,-1,1,Loss,1,1,1,5,5,1,2
2021,2021-02-24, Mogadishu City Club , Raadsan FC ,1,0,1,-1,Win,4,4,0,0,0,0,0
2021,2021-02-25, Horseed S.C , Geeska Afrika FC ,3,1,2,-2,Win,2,0,0,0,0,0,0
2021,2021-02-26, Jeenyo  FC , Midnimo FC ,1,0,1,-1,Win,1,2,0,0,0,0,1
2021,2021-03-01, Heegan S.C , Elman FC ,1,0,1,-1,Win,2,2,2,2,2,2,6
2021,2021-03-02, Dekedda SC , Raadsan FC ,1,2,-1,1,Loss,2,3,1,0,0,1,0
2021,2021-03-02, Gaadiidka FC , Geeska Afrika FC ,6,0,6,-6,Win,1,0,0,0,0,0,0
2021,2021-03-04, Mogadishu City Club , Midnimo FC ,1,0,1,-1,Win,4,2,1,0,0,1,1
2021,2021-03-05, Horseed S.C , Jeenyo  FC ,3,0,3,-3,Win,3,2,2,3,3,2,3
2021,2021-03-08, Raadsan FC , Heegan S.C ,0,0,0,0,Draw,3,2,0,1,1,0,0
2021,2021-03-09, Elman FC , Geeska Afrika FC ,4,0,4,-4,Win,1,0,0,0,0,0,0
2021,2021-03-10, Dekedda SC , Midnimo FC ,1,2,-1,1,Loss,2,2,1,0,0,1,2
2021,2021-03-11, Gaadiidka FC , Jeenyo  FC ,2,2,0,0,Draw,2,2,3,2,2,3,3
2021,2021-03-12, Mogadishu City Club , Horseed S.C ,1,1,0,0,Draw,4,3,5,2,2,5,5
2021,2021-03-15, Heegan S.C , Geeska Afrika FC ,1,1,0,0,Draw,2,0,0,0,0,0,0
2021,2021-03-16, Raadsan FC , Midnimo FC ,1,0,1,-1,Win,2,3,0,1,1,0,1
2021,2021-03-17, Elman FC , Jeenyo  FC ,1,2,-1,1,Loss,2,1,2,0,0,2,7
2021,2021-03-18, Dekedda SC , Horseed S.C ,0,2,-2,2,Loss,1,3,2,2,2,2,7
2021,2021-03-19, Gaadiidka FC , Mogadishu City Club ,0,1,-1,1,Loss,2,4,1,6,6,1,2
2021,2021-05-17, Heegan S.C , Midnimo FC ,2,1,1,-1,Win,2,2,2,0,0,2,0
2021,2021-05-18, Jeenyo  FC , Geeska Afrika FC ,4,2,2,-2,Win,2,0,0,0,0,0,1
2021,2021-05-19, Horseed S.C , Raadsan FC ,0,0,0,0,Draw,4,2,1,1,1,1,0
2021,2021-05-20, Mogadishu City Club , Elman FC ,2,2,0,0,Draw,4,2,3,0,0,3,8
2021,2021-05-21, Gaadiidka FC , Dekedda SC ,0,3,-3,3,Loss,1,0,0,3,3,0,7
2021,2021-05-24, Heegan S.C , Jeenyo  FC ,1,1,0,0,Draw,2,3,3,1,1,3,6
2021,2021-05-25, Horseed S.C , Midnimo FC ,5,2,3,-3,Win,3,1,2,0,0,2,0
2021,2021-05-25, Mogadishu City Club , Geeska Afrika FC ,4,0,4,-4,Win,3,0,0,0,0,0,0
2021,2021-05-27, Gaadiidka FC , Raadsan FC ,1,1,0,0,Draw,1,2,1,2,2,1,0
2021,2021-05-31, Dekedda SC , Elman FC ,1,1,0,0,Draw,1,2,4,5,5,4,2
2021,2021-06-01, Horseed S.C , Heegan S.C ,1,1,0,0,Draw,3,2,3,4,4,3,7
2021,2021-06-02, Mogadishu City Club , Jeenyo  FC ,2,1,1,-1,Win,3,2,2,3,3,2,4
2021,2021-06-03, Gaadiidka FC , Midnimo FC ,1,2,-1,1,Loss,1,1,1,0,0,1,1
2021,2021-06-04, Dekedda SC , Geeska Afrika FC ,1,2,-1,1,Loss,1,0,0,0,0,0,0
2021,2021-06-05, Elman FC , Raadsan FC ,3,2,1,-1,Win,1,2,1,1,1,1,0
2021,2021-06-06, Heegan S.C , Mogadishu City Club ,1,0,1,-1,Win,1,3,1,3,3,1,8
2021,2021-06-07, Gaadiidka FC , Horseed S.C ,0,5,-5,5,Loss,0,2,0,3,3,0,4
2021,2021-06-08, Dekedda SC , Jeenyo  FC ,3,1,2,-2,Win,1,2,4,2,2,4,4
2021,2021-06-09, Elman FC , Midnimo FC ,0,2,-2,2,Loss,2,2,0,1,1,0,2
2021,2021-06-10, Raadsan FC , Geeska Afrika FC ,3,0,3,-3,Win,1,1,1,1,1,1,1
2021,2021-06-27, Gaadiidka FC , Heegan S.C ,2,3,-1,1,Loss,0,2,0,6,6,0,2
2021,2021-06-28, Dekedda SC , Mogadishu City Club ,1,1,0,0,Draw,2,3,3,2,2,3,5
2021,2021-06-29, Horseed S.C , Elman FC ,2,0,2,-2,Win,3,1,3,3,3,3,5
2021,2021-06-30, Raadsan FC , Jeenyo  FC ,0,0,0,0,Draw,2,2,0,0,0,0,1
2021,2021-07-01, Geeska Afrika FC , Midnimo FC ,0,4,-4,4,Loss,1,2,2,3,3,2,0
2021,2021-07-02, Heegan S.C , Dekedda SC ,1,5,-4,4,Loss,3,2,3,3,3,3,6
2021,2021-07-03, Elman FC , Gaadiidka FC ,0,2,-2,2,Loss,1,0,5,1,1,5,2
2021,2021-07-04, Raadsan FC , Mogadishu City Club ,1,1,0,0,Draw,1,2,0,1,1,0,0
2021,2021-07-05, Geeska Afrika FC , Horseed S.C ,0,4,-4,4,Loss,1,3,0,1,1,0,0
2021,2021-07-06, Midnimo FC , Jeenyo  FC ,1,0,1,-1,Win,3,1,0,1,1,0,1
2021,2021-07-07, Elman FC , Heegan S.C ,1,2,-1,1,Loss,1,2,2,3,3,2,6
2021,2021-07-08, Raadsan FC , Dekedda SC ,0,2,-2,2,Loss,1,2,0,1,1,0,0
2021,2021-07-09, Geeska Afrika FC , Gaadiidka FC ,1,8,-7,7,Loss,1,1,0,1,1,0,0
2021,2021-07-10, Midnimo FC , Mogadishu City Club ,0,2,-2,2,Loss,4,2,0,2,2,0,1
2021,2021-07-11, Jeenyo  FC , Horseed S.C ,1,3,-2,2,Loss,0,4,3,3,3,3,3
2021,2021-07-12, Heegan S.C , Raadsan FC ,0,1,-1,1,Loss,3,1,1,0,0,1,1
2021,2021-07-13, Geeska Afrika FC , Elman FC ,0,5,-5,5,Loss,1,1,0,1,1,0,0
2021,2021-07-14, Midnimo FC , Dekedda SC ,0,0,0,0,Draw,4,3,0,1,1,0,2
2021,2021-07-16, Jeenyo  FC , Gaadiidka FC ,1,2,-1,1,Loss,0,2,2,3,3,2,4
2021,2021-07-16, Horseed S.C , Mogadishu City Club ,0,0,0,0,Draw,4,2,2,5,5,2,6
2021,2021-07-17, Geeska Afrika FC , Heegan S.C ,0,13,-13,13,Loss,0,3,0,0,0,0,1
2021,2021-07-18, Midnimo FC , Raadsan FC ,0,2,-2,2,Loss,3,2,1,1,1,1,1
2021,2021-07-21, Jeenyo  FC , Elman FC ,2,1,1,-1,Win,0,1,0,2,2,0,7
2021,2021-07-22, Horseed S.C , Dekedda SC ,1,0,1,-1,Win,4,3,2,2,2,2,7
2021,2021-07-23, Mogadishu City Club , Gaadiidka FC ,4,2,2,-2,Win,1,3,6,1,1,6,2
